Dto Local,Nom Mpio,Municipio,No. de Seccion,Tipo,Lista Nominal,PAN,PRI_PVEM,PRD,PT,PCP,PMC,PNA,CC_PAN_PNA,FORMULAS NO REGISTRADAS,VOTACION VALIDA EMITIDA,VOTOS NULOS,VOTACION EMITIDA,PAN_PNA,CC_1
5,28,SAN LUIS POTOSI ,773,B01,705,112,196,18,6,0,10,6,28,0,376,8,384,146,PAN_PNA
5,28,SAN LUIS POTOSI ,773,C01,705,129,174,19,8,2,9,8,15,0,364,19,383,152,PAN_PNA
5,28,SAN LUIS POTOSI ,773,C02,705,114,192,19,7,3,10,9,12,0,366,12,378,135,PAN_PNA
5,28,SAN LUIS POTOSI ,773,C03,705,118,196,25,12,4,9,16,13,0,393,11,404,147,PAN_PNA
5,28,SAN LUIS POTOSI ,773,C04,705,114,208,36,8,6,8,10,25,0,415,16,431,149,PAN_PNA
5,28,SAN LUIS POTOSI ,773,C05,704,95,213,12,8,1,14,11,14,0,368,11,379,120,PAN_PNA
5,28,SAN LUIS POTOSI ,773,C06,704,108,212,21,7,5,13,7,15,0,388,7,395,130,PAN_PNA
5,28,SAN LUIS POTOSI ,773,C07,704,82,212,23,4,6,10,10,24,0,371,17,388,116,PAN_PNA
5,28,SAN LUIS POTOSI ,773,C08,705,106,198,28,5,2,9,7,21,0,376,14,390,134,PAN_PNA
5,28,SAN LUIS POTOSI ,773,C09,704,108,203,20,10,4,7,10,12,0,374,17,391,130,PAN_PNA
5,28,SAN LUIS POTOSI ,774,B01,685,77,164,21,7,3,4,5,14,0,295,9,304,96,PAN_PNA
5,28,SAN LUIS POTOSI ,774,C01,685,88,175,15,5,0,9,6,13,0,311,14,325,107,PAN_PNA
5,28,SAN LUIS POTOSI ,774,C02,685,84,127,20,6,3,7,8,19,0,274,8,282,111,PAN_PNA
5,28,SAN LUIS POTOSI ,774,C03,685,60,168,20,15,3,6,6,24,0,302,14,316,90,PAN_PNA
5,28,SAN LUIS POTOSI ,774,C04,685,54,164,25,15,4,3,5,16,0,286,11,297,75,PAN_PNA
5,28,SAN LUIS POTOSI ,774,C05,685,68,128,20,12,7,8,6,11,0,260,11,271,85,PAN_PNA
5,28,SAN LUIS POTOSI ,774,C06,685,82,170,19,8,3,4,4,12,0,302,15,317,98,PAN_PNA
5,28,SAN LUIS POTOSI ,774,C07,684,74,130,32,6,5,7,7,12,0,273,21,294,93,PAN_PNA
5,28,SAN LUIS POTOSI ,774,C08,684,95,131,15,9,2,7,4,13,0,276,15,291,112,PAN_PNA
5,28,SAN LUIS POTOSI ,774,C09,684,65,142,20,8,3,7,13,19,0,277,16,293,97,PAN_PNA
5,28,SAN LUIS POTOSI ,774,C10,684,75,143,15,5,2,2,4,18,0,264,16,280,97,PAN_PNA
5,28,SAN LUIS POTOSI ,775,C10,733,82,158,13,4,1,13,15,8,0,294,13,307,105,PAN_PNA
5,28,SAN LUIS POTOSI ,775,C10,733,77,141,12,8,7,9,9,18,0,281,24,305,104,PAN_PNA
5,28,SAN LUIS POTOSI ,775,C02,733,67,153,22,9,1,5,9,14,0,280,13,293,90,PAN_PNA
5,28,SAN LUIS POTOSI ,775,C03,733,75,189,10,7,3,9,6,22,0,321,14,335,103,PAN_PNA
5,28,SAN LUIS POTOSI ,775,C04,733,75,155,9,8,2,10,8,7,0,274,19,293,90,PAN_PNA
5,28,SAN LUIS POTOSI ,775,C05,733,80,139,16,6,6,8,11,11,0,277,18,295,102,PAN_PNA
5,28,SAN LUIS POTOSI ,775,C06,733,71,150,12,7,5,15,5,11,0,276,13,289,87,PAN_PNA
5,28,SAN LUIS POTOSI ,775,C07,733,67,181,13,9,2,10,3,21,0,306,8,314,91,PAN_PNA
5,28,SAN LUIS POTOSI ,775,C08,732,80,135,18,5,0,8,4,10,0,260,8,268,94,PAN_PNA
5,28,SAN LUIS POTOSI ,775,C09,732,62,142,12,7,8,14,6,11,0,262,16,278,79,PAN_PNA
5,28,SAN LUIS POTOSI ,775,C10,732,67,145,15,6,2,9,6,15,0,265,16,281,88,PAN_PNA
5,28,SAN LUIS POTOSI ,776,B01,709,95,110,14,6,5,19,4,25,0,278,15,293,124,PAN_PNA
5,28,SAN LUIS POTOSI ,776,C01,709,100,96,16,4,2,15,10,12,0,255,13,268,122,PAN_PNA
5,28,SAN LUIS POTOSI ,776,C02,709,84,101,18,6,4,3,5,22,0,243,13,256,111,PAN_PNA
5,28,SAN LUIS POTOSI ,776,C03,708,87,92,24,6,1,16,7,12,0,245,21,266,106,PAN_PNA
5,28,SAN LUIS POTOSI ,776,C04,708,81,96,8,4,3,12,5,21,0,230,23,253,107,PAN_PNA
5,28,SAN LUIS POTOSI ,777,B01,622,94,166,30,6,1,8,8,9,0,322,10,332,111,PAN_PNA
5,28,SAN LUIS POTOSI ,777,C01,621,97,177,29,6,3,11,2,16,0,341,8,349,115,PAN_PNA
5,28,SAN LUIS POTOSI ,778,B01,689,92,192,24,6,2,5,9,16,0,346,18,364,117,PAN_PNA
5,28,SAN LUIS POTOSI ,778,C01,688,101,183,23,9,3,10,13,14,0,356,8,364,128,PAN_PNA
5,28,SAN LUIS POTOSI ,778,C02,688,87,202,31,6,1,7,5,9,0,348,16,364,101,PAN_PNA
5,28,SAN LUIS POTOSI ,778,C03,688,88,200,17,8,2,7,14,14,0,350,11,361,116,PAN_PNA
5,28,SAN LUIS POTOSI ,779,B01,711,99,176,13,7,4,6,10,15,0,330,21,351,124,PAN_PNA
5,28,SAN LUIS POTOSI ,779,C01,711,91,177,19,3,1,8,6,16,0,321,16,337,113,PAN_PNA
5,28,SAN LUIS POTOSI ,779,C02,711,81,189,27,7,1,9,10,23,0,347,17,364,114,PAN_PNA
5,28,SAN LUIS POTOSI ,779,C03,710,84,176,22,4,0,4,13,21,0,324,10,334,118,PAN_PNA
5,28,SAN LUIS POTOSI ,779,C04,710,103,176,16,10,3,6,11,20,0,345,16,361,134,PAN_PNA
5,28,SAN LUIS POTOSI ,780,B01,631,77,152,21,5,1,6,5,17,0,284,19,303,99,PAN_PNA
5,28,SAN LUIS POTOSI ,780,C01,630,63,146,23,2,1,3,5,12,0,255,13,268,80,PAN_PNA
5,28,SAN LUIS POTOSI ,780,C02,630,74,157,33,4,5,6,5,14,0,298,15,313,93,PAN_PNA
5,28,SAN LUIS POTOSI ,780,C03,630,73,178,22,6,3,8,4,15,0,309,12,321,92,PAN_PNA
5,28,SAN LUIS POTOSI ,781,B01,729,99,184,19,3,0,5,9,10,0,329,7,336,118,PAN_PNA
5,28,SAN LUIS POTOSI ,781,C01,729,81,161,20,10,2,16,6,16,0,312,13,325,103,PAN_PNA
5,28,SAN LUIS POTOSI ,781,C02,728,71,130,20,2,4,3,10,7,0,247,13,260,88,PAN_PNA
5,28,SAN LUIS POTOSI ,781,C03,728,99,152,23,7,2,8,5,27,0,323,13,336,131,PAN_PNA
5,28,SAN LUIS POTOSI ,781,C04,728,90,159,14,13,3,8,12,19,0,318,10,328,121,PAN_PNA
5,28,SAN LUIS POTOSI ,782,B01,693,99,125,23,5,8,12,10,17,0,299,17,316,126,PAN_PNA
5,28,SAN LUIS POTOSI ,782,C01,692,103,133,18,6,8,13,2,15,0,298,28,326,120,PAN_PNA
5,28,SAN LUIS POTOSI ,782,C02,692,84,122,16,7,3,21,10,14,0,277,9,286,108,PAN_PNA
5,28,SAN LUIS POTOSI ,783,B01,664,71,148,21,8,4,4,2,20,0,278,21,299,93,PAN_PNA
5,28,SAN LUIS POTOSI ,783,C01,664,83,154,29,8,1,5,10,19,0,309,13,322,112,PAN_PNA
5,28,SAN LUIS POTOSI ,783,C02,664,88,161,12,4,2,7,10,15,0,299,18,317,113,PAN_PNA
5,28,SAN LUIS POTOSI ,783,C03,663,109,182,26,9,4,6,8,13,0,357,17,374,130,PAN_PNA
5,28,SAN LUIS POTOSI ,784,B01,538,72,125,15,8,0,4,7,15,0,246,10,256,94,PAN_PNA
5,28,SAN LUIS POTOSI ,784,C01,537,73,109,15,8,3,15,3,10,0,236,12,248,86,PAN_PNA
5,28,SAN LUIS POTOSI ,784,C02,537,75,133,15,4,2,4,2,11,0,246,17,263,88,PAN_PNA
5,28,SAN LUIS POTOSI ,785,B01,574,55,136,23,2,1,5,6,7,0,235,13,248,68,PAN_PNA
5,28,SAN LUIS POTOSI ,785,C01,573,61,124,26,8,5,6,5,14,0,249,11,260,80,PAN_PNA
5,28,SAN LUIS POTOSI ,785,C02,573,81,156,18,2,4,9,4,9,0,283,9,292,94,PAN_PNA
5,28,SAN LUIS POTOSI ,786,B01,637,129,206,32,9,3,11,9,7,0,406,11,417,145,PAN_PNA
5,28,SAN LUIS POTOSI ,786,C01,637,112,221,28,4,5,5,4,14,0,393,12,405,130,PAN_PNA
5,28,SAN LUIS POTOSI ,786,C02,637,114,190,28,6,8,8,8,10,0,372,15,387,132,PAN_PNA
5,28,SAN LUIS POTOSI ,786,C03,636,119,201,36,4,1,14,12,11,0,398,13,411,142,PAN_PNA
5,28,SAN LUIS POTOSI ,787,B01,719,124,175,17,7,1,8,8,17,0,357,11,368,149,PAN_PNA
5,28,SAN LUIS POTOSI ,787,C01,719,137,158,16,9,4,7,7,15,0,353,18,371,159,PAN_PNA
5,28,SAN LUIS POTOSI ,787,C02,719,131,158,24,7,2,8,11,22,0,363,11,374,164,PAN_PNA
5,28,SAN LUIS POTOSI ,787,C03,719,118,171,22,13,4,4,4,20,0,356,16,372,142,PAN_PNA
5,28,SAN LUIS POTOSI ,787,C04,719,128,173,28,6,7,10,4,11,0,367,15,382,143,PAN_PNA
5,28,SAN LUIS POTOSI ,787,C05,719,113,149,18,11,2,10,14,15,0,332,12,344,142,PAN_PNA
5,28,SAN LUIS POTOSI ,787,C06,719,125,156,18,6,8,4,8,19,0,344,15,359,152,PAN_PNA
5,28,SAN LUIS POTOSI ,787,C07,719,114,170,16,5,9,10,6,20,0,350,20,370,140,PAN_PNA
5,28,SAN LUIS POTOSI ,787,C08,719,121,181,11,8,3,6,11,28,0,369,16,385,160,PAN_PNA
5,28,SAN LUIS POTOSI ,787,C09,718,104,177,20,9,8,5,2,23,0,348,12,360,129,PAN_PNA
5,28,SAN LUIS POTOSI ,788,B01,464,102,141,27,2,2,4,4,21,0,303,9,312,127,PAN_PNA
5,28,SAN LUIS POTOSI ,788,C01,463,118,133,22,2,2,6,5,14,0,302,9,311,137,PAN_PNA
5,28,SAN LUIS POTOSI ,789,B01,695,138,171,22,9,5,5,6,11,0,367,8,375,155,PAN_PNA
5,28,SAN LUIS POTOSI ,789,C01,695,91,184,23,5,6,7,12,10,0,338,21,359,113,PAN_PNA
5,28,SAN LUIS POTOSI ,790,B01,729,94,171,19,8,2,5,4,19,0,322,16,338,117,PAN_PNA
5,28,SAN LUIS POTOSI ,790,C01,728,125,167,18,7,5,5,8,29,0,364,15,379,162,PAN_PNA
5,28,SAN LUIS POTOSI ,790,C02,728,93,201,24,3,3,7,2,17,0,350,10,360,112,PAN_PNA
5,28,SAN LUIS POTOSI ,791,B01,598,79,107,16,6,5,15,10,11,0,249,13,262,100,PAN_PNA
5,28,SAN LUIS POTOSI ,791,C01,598,89,127,28,7,4,7,2,12,0,276,14,290,103,PAN_PNA
5,28,SAN LUIS POTOSI ,791,C02,598,71,115,18,0,9,13,9,6,0,241,13,254,86,PAN_PNA
5,28,SAN LUIS POTOSI ,791,C03,598,90,101,19,3,5,20,4,22,0,264,22,286,116,PAN_PNA
5,28,SAN LUIS POTOSI ,792,B01,654,100,123,24,8,7,33,6,16,0,317,22,339,122,PAN_PNA
5,28,SAN LUIS POTOSI ,792,C01,654,102,131,28,7,5,32,6,19,0,330,15,345,127,PAN_PNA
5,28,SAN LUIS POTOSI ,792,C02,653,101,125,9,2,4,64,9,16,0,330,15,345,126,PAN_PNA
5,28,SAN LUIS POTOSI ,792,C03,653,79,150,18,5,2,57,5,13,0,329,14,343,97,PAN_PNA
5,28,SAN LUIS POTOSI ,793,B01,694,106,181,35,7,2,6,10,16,0,363,14,377,132,PAN_PNA
5,28,SAN LUIS POTOSI ,793,C01,693,106,192,28,8,2,15,10,18,0,379,15,394,134,PAN_PNA
5,28,SAN LUIS POTOSI ,794,B01,736,120,168,25,8,6,4,9,20,0,360,28,388,149,PAN_PNA
5,28,SAN LUIS POTOSI ,794,C01,736,117,183,25,9,6,3,7,15,0,365,28,393,139,PAN_PNA
5,28,SAN LUIS POTOSI ,794,C02,736,114,153,22,8,8,4,11,17,0,337,21,358,142,PAN_PNA
5,28,SAN LUIS POTOSI ,795,B01,744,98,184,29,3,7,8,9,22,0,360,18,378,129,PAN_PNA
5,28,SAN LUIS POTOSI ,795,C01,744,91,188,22,8,5,4,10,16,0,344,7,351,117,PAN_PNA
5,28,SAN LUIS POTOSI ,795,C02,744,121,196,24,7,7,9,15,14,0,393,24,417,150,PAN_PNA
5,28,SAN LUIS POTOSI ,796,B01,595,99,165,23,11,1,5,5,26,0,335,12,347,130,PAN_PNA
5,28,SAN LUIS POTOSI ,796,C01,595,148,144,18,4,3,3,6,37,0,363,14,377,191,PAN_PNA
5,28,SAN LUIS POTOSI ,796,C02,595,117,143,14,10,5,7,8,16,0,320,11,331,141,PAN_PNA
5,28,SAN LUIS POTOSI ,796,C03,594,121,146,24,6,7,6,3,22,0,335,17,352,146,PAN_PNA
5,28,SAN LUIS POTOSI ,797,B01,618,93,153,21,7,4,5,7,9,0,299,9,308,109,PAN_PNA
5,28,SAN LUIS POTOSI ,797,C01,617,93,180,17,7,3,2,13,12,0,327,19,346,118,PAN_PNA
5,28,SAN LUIS POTOSI ,797,C02,617,74,154,23,11,3,3,9,15,0,292,15,307,98,PAN_PNA
5,28,SAN LUIS POTOSI ,798,B01,565,135,124,27,3,0,7,3,17,0,316,12,328,155,PAN_PNA
5,28,SAN LUIS POTOSI ,798,C01,564,116,125,18,7,3,9,5,19,0,302,20,322,140,PAN_PNA
5,28,SAN LUIS POTOSI ,799,B01,410,60,124,19,0,3,2,3,15,0,226,9,235,78,PAN_PNA
5,28,SAN LUIS POTOSI ,799,C01,409,60,118,25,5,2,8,9,9,0,236,10,246,78,PAN_PNA
5,28,SAN LUIS POTOSI ,800,B01,648,133,224,25,3,7,2,9,22,0,425,9,434,164,PAN_PNA
5,28,SAN LUIS POTOSI ,800,C01,647,127,214,20,5,6,5,9,18,0,404,18,422,154,PAN_PNA
5,28,SAN LUIS POTOSI ,801,B01,658,136,197,36,4,6,7,9,19,0,414,19,433,164,PAN_PNA
5,28,SAN LUIS POTOSI ,801,C01,657,96,230,33,3,2,10,9,16,0,399,6,405,121,PAN_PNA
5,28,SAN LUIS POTOSI ,802,B01,654,119,190,28,6,1,4,7,28,0,383,15,398,154,PAN_PNA
5,28,SAN LUIS POTOSI ,802,C01,654,130,190,37,2,9,11,7,23,0,409,11,420,160,PAN_PNA
5,28,SAN LUIS POTOSI ,803,B01,642,136,205,32,6,3,3,9,15,0,409,11,420,160,PAN_PNA
5,28,SAN LUIS POTOSI ,803,C01,641,168,178,23,8,3,6,9,13,0,408,10,418,190,PAN_PNA
5,28,SAN LUIS POTOSI ,803,C02,641,153,194,22,4,3,10,9,21,0,416,10,426,183,PAN_PNA
5,28,SAN LUIS POTOSI ,803,C03,641,151,200,31,2,2,7,7,15,0,415,10,425,173,PAN_PNA
5,28,SAN LUIS POTOSI ,804,B01,719,145,235,28,8,1,10,16,17,0,460,32,492,178,PAN_PNA
5,28,SAN LUIS POTOSI ,805,B01,713,118,184,25,8,1,8,5,22,0,371,15,386,145,PAN_PNA
5,28,SAN LUIS POTOSI ,805,C01,713,114,209,15,3,4,8,15,20,0,388,9,397,149,PAN_PNA
5,28,SAN LUIS POTOSI ,805,C02,713,141,195,29,6,2,7,10,14,0,404,17,421,165,PAN_PNA
5,28,SAN LUIS POTOSI ,805,C03,712,111,193,22,5,5,9,12,15,0,372,22,394,138,PAN_PNA
5,28,SAN LUIS POTOSI ,805,C04,712,136,172,14,9,3,11,5,15,0,365,19,384,156,PAN_PNA
5,28,SAN LUIS POTOSI ,805,C05,712,114,178,20,14,5,9,11,20,0,371,17,388,145,PAN_PNA
5,28,SAN LUIS POTOSI ,805,C06,712,120,176,27,7,2,5,5,11,0,353,12,365,136,PAN_PNA
5,28,SAN LUIS POTOSI ,805,C07,712,122,200,24,8,0,10,10,15,0,389,14,403,147,PAN_PNA
5,28,SAN LUIS POTOSI ,806,B01,477,117,164,29,7,3,5,3,12,0,340,14,354,132,PAN_PNA
5,28,SAN LUIS POTOSI ,806,C01,476,95,157,28,7,2,3,4,9,0,305,6,311,108,PAN_PNA
5,28,SAN LUIS POTOSI ,807,B01,552,146,164,31,5,4,5,5,14,0,374,12,386,165,PAN_PNA
5,28,SAN LUIS POTOSI ,807,C01,552,138,146,32,5,4,9,9,13,0,356,14,370,160,PAN_PNA
5,28,SAN LUIS POTOSI ,808,B01,655,66,169,22,3,8,21,9,13,0,311,18,329,88,PAN_PNA
5,28,SAN LUIS POTOSI ,808,C01,654,105,159,26,10,4,16,5,15,0,340,13,353,125,PAN_PNA
5,28,SAN LUIS POTOSI ,808,C02,654,92,161,19,4,1,21,8,13,0,319,20,339,113,PAN_PNA
5,28,SAN LUIS POTOSI ,809,B01,524,71,146,17,4,3,16,8,9,0,274,11,285,88,PAN_PNA
5,28,SAN LUIS POTOSI ,809,C01,524,84,143,22,3,4,10,3,14,0,283,6,289,101,PAN_PNA
5,28,SAN LUIS POTOSI ,809,C02,524,72,146,13,4,2,12,7,11,0,267,13,280,90,PAN_PNA
5,28,SAN LUIS POTOSI ,810,B01,511,100,159,29,7,3,11,4,16,0,329,12,341,120,PAN_PNA
5,28,SAN LUIS POTOSI ,810,C01,510,107,150,15,3,7,13,9,10,0,314,16,330,126,PAN_PNA
5,28,SAN LUIS POTOSI ,810,C02,510,93,145,18,3,3,20,6,16,0,304,11,315,115,PAN_PNA
5,28,SAN LUIS POTOSI ,811,B01,712,148,212,43,9,7,13,9,17,0,458,16,474,174,PAN_PNA
5,28,SAN LUIS POTOSI ,812,B01,723,173,226,31,2,3,10,13,19,0,477,9,486,205,PAN_PNA
5,28,SAN LUIS POTOSI ,812,C01,723,183,232,36,2,3,9,5,20,0,490,14,504,208,PAN_PNA
5,28,SAN LUIS POTOSI ,813,B01,630,135,192,37,4,4,5,5,14,0,396,16,412,154,PAN_PNA
5,28,SAN LUIS POTOSI ,813,C01,630,155,162,39,4,2,4,8,24,0,398,10,408,187,PAN_PNA
5,28,SAN LUIS POTOSI ,814,B01,508,84,150,16,0,4,3,3,15,0,275,12,287,102,PAN_PNA
5,28,SAN LUIS POTOSI ,814,C01,508,88,123,16,4,3,5,10,12,0,261,10,271,110,PAN_PNA
5,28,SAN LUIS POTOSI ,815,B01,483,93,136,17,5,2,6,9,9,0,277,0,277,111,PAN_PNA
5,28,SAN LUIS POTOSI ,815,C01,482,81,132,23,2,1,9,8,7,0,263,7,270,96,PAN_PNA
5,28,SAN LUIS POTOSI ,816,B01,568,116,188,29,4,5,6,8,10,0,366,14,380,134,PAN_PNA
5,28,SAN LUIS POTOSI ,816,C01,568,111,155,30,3,3,7,10,20,0,339,10,349,141,PAN_PNA
5,28,SAN LUIS POTOSI ,816,C02,567,114,179,37,5,2,2,10,14,0,363,12,375,138,PAN_PNA
5,28,SAN LUIS POTOSI ,817,B01,584,155,161,38,3,1,13,4,18,0,393,9,402,177,PAN_PNA
5,28,SAN LUIS POTOSI ,817,C01,583,163,153,32,0,5,7,8,11,0,379,11,390,182,PAN_PNA
5,28,SAN LUIS POTOSI ,818,B01,688,153,208,30,3,3,11,6,16,0,430,16,446,175,PAN_PNA
5,28,SAN LUIS POTOSI ,819,B01,453,90,161,18,7,1,2,5,9,0,293,11,304,104,PAN_PNA
5,28,SAN LUIS POTOSI ,819,C01,453,94,148,18,3,8,4,2,22,0,299,19,318,118,PAN_PNA
5,28,SAN LUIS POTOSI ,820,B01,376,97,100,14,2,2,3,9,16,0,243,11,254,122,PAN_PNA
5,28,SAN LUIS POTOSI ,820,C01,376,87,111,20,3,2,10,4,16,0,253,12,265,107,PAN_PNA
5,28,SAN LUIS POTOSI ,821,B01,700,104,182,39,5,7,9,8,15,0,369,25,394,127,PAN_PNA
5,28,SAN LUIS POTOSI ,821,C01,700,128,155,26,6,1,8,9,23,0,356,26,382,160,PAN_PNA
5,28,SAN LUIS POTOSI ,821,C02,700,151,162,19,5,9,4,8,21,0,379,13,392,180,PAN_PNA
5,28,SAN LUIS POTOSI ,822,B01,677,106,207,15,6,2,7,7,11,0,361,11,372,124,PAN_PNA
5,28,SAN LUIS POTOSI ,822,C01,677,119,199,38,8,1,6,12,8,0,391,15,406,139,PAN_PNA
5,28,SAN LUIS POTOSI ,837,B01,565,104,161,33,8,3,4,13,9,0,335,10,345,126,PAN_PNA
5,28,SAN LUIS POTOSI ,837,C01,564,79,187,30,3,3,4,7,8,0,321,8,329,94,PAN_PNA
5,28,SAN LUIS POTOSI ,1076,B01,462,153,112,0,2,1,1,4,37,0,310,15,325,194,PAN_PNA
5,28,SAN LUIS POTOSI ,1077,B01,488,133,129,3,3,0,1,7,40,0,316,16,332,180,PAN_PNA
5,28,SAN LUIS POTOSI ,1078,B01,158,55,29,0,0,0,0,0,4,0,88,7,95,59,PAN_PNA
5,28,SAN LUIS POTOSI ,1079,B01,354,106,64,1,5,1,0,4,24,0,205,9,214,134,PAN_PNA
5,28,SAN LUIS POTOSI ,1080,B01,129,48,16,2,1,0,0,1,7,0,75,2,77,56,PAN_PNA
5,28,SAN LUIS POTOSI ,1081,B01,182,63,35,2,0,0,1,1,10,0,112,7,119,74,PAN_PNA
5,28,SAN LUIS POTOSI ,1082,B01,255,72,41,3,1,3,0,2,16,0,138,2,140,90,PAN_PNA
5,28,SAN LUIS POTOSI ,1083,B01,161,33,26,1,4,1,0,1,5,0,71,4,75,39,PAN_PNA
5,28,SAN LUIS POTOSI ,1084,B01,313,28,58,0,0,0,1,2,1,0,90,6,96,31,PAN_PNA
5,28,SAN LUIS POTOSI ,1085,B01,218,35,70,0,6,1,0,2,6,0,120,13,133,43,PAN_PNA
5,28,SAN LUIS POTOSI ,1086,B01,425,118,89,5,2,1,0,3,38,0,256,8,264,159,PAN_PNA
5,28,SAN LUIS POTOSI ,1086,C01,425,121,89,2,3,0,1,4,19,0,239,10,249,144,PAN_PNA
5,28,SAN LUIS POTOSI ,1087,B01,222,57,41,0,1,1,0,2,10,0,112,8,120,69,PAN_PNA
5,28,SAN LUIS POTOSI ,1088,B01,478,125,136,8,1,0,3,3,20,0,296,12,308,148,PAN_PNA
5,28,SAN LUIS POTOSI ,1089,B01,327,71,102,10,2,1,0,6,13,0,205,6,211,90,PAN_PNA
5,28,SAN LUIS POTOSI ,1090,B01,412,73,127,14,9,0,4,4,18,0,249,9,258,95,PAN_PNA
5,28,SAN LUIS POTOSI ,1091,B01,243,36,43,5,3,4,1,1,2,0,95,6,101,39,PAN_PNA
5,28,SAN LUIS POTOSI ,1092,B01,568,77,181,7,0,1,1,1,3,0,271,14,285,81,PAN_PNA
5,28,SAN LUIS POTOSI ,1093,B01,495,169,62,7,4,0,0,4,10,0,256,30,286,183,PAN_PNA
5,28,SAN LUIS POTOSI ,1094,B01,113,21,46,1,1,1,0,1,1,0,72,4,76,23,PAN_PNA
5,28,SAN LUIS POTOSI ,1095,B01,158,56,5,3,1,0,1,2,4,0,72,1,73,62,PAN_PNA
5,28,SAN LUIS POTOSI ,1096,B01,699,176,93,4,4,4,2,9,15,0,307,27,334,200,PAN_PNA
5,28,SAN LUIS POTOSI ,1097,B01,550,172,29,0,1,0,9,6,22,0,239,7,246,200,PAN_PNA
5,28,SAN LUIS POTOSI ,1098,B01,167,39,12,1,1,0,1,1,8,0,63,4,67,48,PAN_PNA
5,28,SAN LUIS POTOSI ,1099,B01,127,38,16,2,2,1,0,2,5,0,66,2,68,45,PAN_PNA
5,28,SAN LUIS POTOSI ,1100,B01,474,99,66,4,0,0,12,7,17,0,205,10,215,123,PAN_PNA
5,28,SAN LUIS POTOSI ,1100,C01,473,102,54,5,3,0,4,6,20,0,194,13,207,128,PAN_PNA
5,28,SAN LUIS POTOSI ,1101,B01,470,36,49,1,1,24,0,3,14,0,128,6,134,53,PAN_PNA
5,28,SAN LUIS POTOSI ,1101,C01,469,50,59,4,1,14,0,3,15,0,146,9,155,68,PAN_PNA
5,28,SAN LUIS POTOSI ,1102,B01,195,31,35,0,1,0,11,1,10,0,89,9,98,42,PAN_PNA
5,28,SAN LUIS POTOSI ,1103,B01,501,62,110,5,2,0,22,3,9,0,213,20,233,74,PAN_PNA
5,28,SAN LUIS POTOSI ,1104,B01,474,88,68,6,4,6,4,4,25,0,205,14,219,117,PAN_PNA
5,28,SAN LUIS POTOSI ,1104,C01,473,74,94,3,2,5,2,5,20,0,205,13,218,99,PAN_PNA
5,28,SAN LUIS POTOSI ,1105,B01,729,82,125,3,4,6,1,5,16,0,242,9,251,103,PAN_PNA
5,28,SAN LUIS POTOSI ,1106,B01,729,236,219,37,15,4,6,19,48,0,584,50,634,303,PAN_PNA
5,28,SAN LUIS POTOSI ,1106,C01,728,158,88,20,2,0,2,7,14,0,291,9,300,179,PAN_PNA
6,28,SAN LUIS POTOSI ,838,B01,489,77,147,20,5,4,9,7,11,0,280,11,291,95,PAN_PNA
6,28,SAN LUIS POTOSI ,838,C01,488,91,120,22,8,5,12,8,13,0,279,9,288,112,PAN_PNA
6,28,SAN LUIS POTOSI ,839,B01,641,151,203,24,5,1,15,9,13,0,421,12,433,173,PAN_PNA
6,28,SAN LUIS POTOSI ,839,C01,640,137,208,26,6,5,8,12,14,0,416,19,435,163,PAN_PNA
6,28,SAN LUIS POTOSI ,840,B01,558,130,137,27,9,3,16,1,8,0,331,17,348,139,PAN_PNA
6,28,SAN LUIS POTOSI ,840,C01,557,103,141,28,11,5,11,4,17,0,320,18,338,124,PAN_PNA
6,28,SAN LUIS POTOSI ,841,B01,420,65,95,14,5,2,31,3,7,0,222,11,233,75,PAN_PNA
6,28,SAN LUIS POTOSI ,841,C01,420,68,110,15,2,1,21,1,9,0,227,5,232,78,PAN_PNA
6,28,SAN LUIS POTOSI ,849,B01,509,80,138,24,1,6,11,5,7,0,272,13,285,92,PAN_PNA
6,28,SAN LUIS POTOSI ,849,C01,508,70,141,14,2,6,17,0,10,0,260,16,276,80,PAN_PNA
6,28,SAN LUIS POTOSI ,850,B01,378,61,117,12,1,0,6,2,6,0,205,9,214,69,PAN_PNA
6,28,SAN LUIS POTOSI ,850,C01,378,52,94,16,2,2,11,6,5,0,188,9,197,63,PAN_PNA
6,28,SAN LUIS POTOSI ,851,B01,726,174,191,53,9,5,18,10,12,0,472,16,488,196,PAN_PNA
6,28,SAN LUIS POTOSI ,851,C01,725,178,181,36,5,8,19,14,22,0,463,15,478,214,PAN_PNA
6,28,SAN LUIS POTOSI ,852,B01,393,85,116,21,3,4,5,8,15,0,257,15,272,108,PAN_PNA
6,28,SAN LUIS POTOSI ,852,C01,393,77,99,17,5,5,9,4,8,0,224,13,237,89,PAN_PNA
6,28,SAN LUIS POTOSI ,853,B01,420,85,103,26,1,1,1,7,8,13,245,0,245,100,PAN_PNA
6,28,SAN LUIS POTOSI ,854,B01,455,46,119,10,3,8,20,5,9,0,220,14,234,60,PAN_PNA
6,28,SAN LUIS POTOSI ,854,C01,455,70,104,15,4,19,16,4,14,0,246,10,256,88,PAN_PNA
6,28,SAN LUIS POTOSI ,855,B01,590,106,143,24,6,7,10,2,14,0,312,11,323,122,PAN_PNA
6,28,SAN LUIS POTOSI ,856,B01,488,74,99,16,3,1,24,5,11,0,233,11,244,90,PAN_PNA
6,28,SAN LUIS POTOSI ,856,C01,487,61,122,16,1,2,22,4,6,0,234,11,245,71,PAN_PNA
6,28,SAN LUIS POTOSI ,863,B01,552,134,155,31,7,5,13,7,18,0,370,10,380,159,PAN_PNA
6,28,SAN LUIS POTOSI ,863,C01,551,129,148,22,3,6,14,5,22,0,349,14,363,156,PAN_PNA
6,28,SAN LUIS POTOSI ,863,C02,551,153,138,28,4,9,9,8,15,0,364,17,381,176,PAN_PNA
6,28,SAN LUIS POTOSI ,864,B01,446,53,111,20,3,8,7,1,3,0,206,12,218,57,PAN_PNA
6,28,SAN LUIS POTOSI ,873,B01,285,38,93,15,0,0,4,2,5,0,157,6,163,45,PAN_PNA
6,28,SAN LUIS POTOSI ,874,B01,558,89,148,14,5,4,5,12,12,0,289,15,304,113,PAN_PNA
6,28,SAN LUIS POTOSI ,875,B01,695,141,183,39,3,7,28,11,11,0,423,12,435,163,PAN_PNA
6,28,SAN LUIS POTOSI ,876,B01,413,81,130,22,3,3,13,5,4,0,261,3,264,90,PAN_PNA
6,28,SAN LUIS POTOSI ,876,C01,412,85,92,22,9,6,11,8,9,0,242,12,254,102,PAN_PNA
6,28,SAN LUIS POTOSI ,877,B01,728,140,218,43,3,9,12,10,10,0,445,23,468,160,PAN_PNA
6,28,SAN LUIS POTOSI ,877,C01,728,178,246,54,4,9,14,11,18,0,534,13,547,207,PAN_PNA
6,28,SAN LUIS POTOSI ,878,B01,486,94,119,24,4,3,9,14,7,0,274,11,285,115,PAN_PNA
6,28,SAN LUIS POTOSI ,878,C01,485,94,147,15,2,2,15,6,6,0,287,10,297,106,PAN_PNA
6,28,SAN LUIS POTOSI ,879,B01,413,86,126,18,3,3,9,8,7,0,260,11,271,101,PAN_PNA
6,28,SAN LUIS POTOSI ,879,C01,412,92,113,16,3,2,6,10,9,0,251,13,264,111,PAN_PNA
6,28,SAN LUIS POTOSI ,880,B01,491,67,134,25,4,3,7,6,8,0,254,7,261,81,PAN_PNA
6,28,SAN LUIS POTOSI ,894,B01,185,35,47,5,0,3,0,5,6,0,101,3,104,46,PAN_PNA
6,28,SAN LUIS POTOSI ,895,B01,470,65,104,17,2,3,12,5,8,0,216,14,230,78,PAN_PNA
6,28,SAN LUIS POTOSI ,896,B01,467,103,160,12,5,7,10,3,12,0,312,17,329,118,PAN_PNA
6,28,SAN LUIS POTOSI ,896,C01,466,99,153,25,3,4,8,8,10,0,310,9,319,117,PAN_PNA
6,28,SAN LUIS POTOSI ,897,B01,405,92,112,22,7,2,4,5,6,0,250,7,257,103,PAN_PNA
6,28,SAN LUIS POTOSI ,897,C01,405,68,126,18,3,2,5,5,14,0,241,9,250,87,PAN_PNA
6,28,SAN LUIS POTOSI ,898,B01,459,93,121,22,4,6,6,12,11,0,275,5,280,116,PAN_PNA
6,28,SAN LUIS POTOSI ,898,C01,459,90,123,27,7,12,9,1,9,0,278,11,289,100,PAN_PNA
6,28,SAN LUIS POTOSI ,899,B01,515,88,148,43,2,12,14,7,13,0,327,13,340,108,PAN_PNA
6,28,SAN LUIS POTOSI ,900,B01,532,84,157,18,2,11,11,8,11,1,303,15,318,103,PAN_PNA
6,28,SAN LUIS POTOSI ,901,B01,453,80,129,20,2,14,9,5,10,0,269,8,277,95,PAN_PNA
6,28,SAN LUIS POTOSI ,901,C01,452,77,124,17,5,5,11,4,4,0,247,5,252,85,PAN_PNA
6,28,SAN LUIS POTOSI ,902,B01,609,138,149,29,9,6,13,14,18,0,376,26,402,170,PAN_PNA
6,28,SAN LUIS POTOSI ,919,B01,649,141,165,27,7,13,13,8,19,0,393,14,407,168,PAN_PNA
6,28,SAN LUIS POTOSI ,920,B01,434,98,132,18,2,4,8,9,8,0,279,11,290,115,PAN_PNA
6,28,SAN LUIS POTOSI ,920,C01,434,96,114,21,3,0,8,5,8,0,255,8,263,109,PAN_PNA
6,28,SAN LUIS POTOSI ,921,B01,515,92,151,23,5,4,13,8,12,0,308,12,320,112,PAN_PNA
6,28,SAN LUIS POTOSI ,921,C01,515,129,150,14,2,6,13,7,16,0,337,15,352,152,PAN_PNA
6,28,SAN LUIS POTOSI ,921,C02,515,133,150,14,2,6,13,9,10,0,337,15,352,152,PAN_PNA
6,28,SAN LUIS POTOSI ,925,B01,380,52,128,13,4,2,6,5,6,0,216,10,226,63,PAN_PNA
6,28,SAN LUIS POTOSI ,925,C01,379,80,112,21,3,1,5,2,8,0,232,9,241,90,PAN_PNA
6,28,SAN LUIS POTOSI ,926,B01,515,79,143,26,7,5,8,11,7,0,286,5,291,97,PAN_PNA
6,28,SAN LUIS POTOSI ,926,C01,514,86,157,23,7,3,14,4,14,0,308,11,319,104,PAN_PNA
6,28,SAN LUIS POTOSI ,927,B01,381,68,123,14,3,3,5,7,6,0,229,12,241,81,PAN_PNA
6,28,SAN LUIS POTOSI ,927,C01,380,99,92,20,6,4,6,3,18,0,248,13,261,120,PAN_PNA
6,28,SAN LUIS POTOSI ,931,B01,662,134,213,30,9,4,9,8,10,0,417,18,435,152,PAN_PNA
6,28,SAN LUIS POTOSI ,931,C01,661,143,195,38,8,4,13,14,16,0,431,15,446,173,PAN_PNA
6,28,SAN LUIS POTOSI ,932,B01,701,177,202,38,6,2,12,13,16,0,466,11,477,206,PAN_PNA
6,28,SAN LUIS POTOSI ,932,C01,701,185,217,36,8,3,13,7,15,0,484,17,501,207,PAN_PNA
6,28,SAN LUIS POTOSI ,951,B01,408,91,111,30,4,6,6,1,11,0,260,4,264,103,PAN_PNA
6,28,SAN LUIS POTOSI ,951,C01,408,80,139,17,6,3,4,6,10,0,265,6,271,96,PAN_PNA
6,28,SAN LUIS POTOSI ,971,B01,504,104,152,27,4,3,5,12,7,0,314,10,324,123,PAN_PNA
6,28,SAN LUIS POTOSI ,971,C01,503,80,138,35,9,3,4,4,9,0,282,7,289,93,PAN_PNA
6,28,SAN LUIS POTOSI ,972,B01,730,137,192,35,13,6,13,8,15,0,419,9,428,160,PAN_PNA
6,28,SAN LUIS POTOSI ,972,C01,730,122,201,28,10,9,14,10,15,0,409,17,426,147,PAN_PNA
6,28,SAN LUIS POTOSI ,972,C02,730,130,180,30,8,6,14,8,8,0,384,14,398,146,PAN_PNA
6,28,SAN LUIS POTOSI ,972,C03,730,149,194,35,8,7,18,9,16,0,436,13,449,174,PAN_PNA
6,28,SAN LUIS POTOSI ,972,C04,730,128,185,28,4,4,13,14,20,0,396,12,408,162,PAN_PNA
6,28,SAN LUIS POTOSI ,972,C05,730,139,185,39,11,5,8,12,19,0,418,17,435,170,PAN_PNA
6,28,SAN LUIS POTOSI ,972,C06,730,133,173,24,13,3,13,14,20,0,393,12,405,167,PAN_PNA
6,28,SAN LUIS POTOSI ,972,C07,730,115,223,27,6,8,9,9,10,0,407,11,418,134,PAN_PNA
6,28,SAN LUIS POTOSI ,972,C08,730,166,165,30,9,7,14,15,13,0,419,10,429,194,PAN_PNA
6,28,SAN LUIS POTOSI ,972,C09,729,135,204,39,11,7,13,13,17,0,439,12,451,165,PAN_PNA
6,28,SAN LUIS POTOSI ,972,C10,729,103,228,34,6,4,12,7,14,0,408,18,426,124,PAN_PNA
6,28,SAN LUIS POTOSI ,972,C11,729,146,174,32,7,7,13,10,11,0,400,11,411,167,PAN_PNA
6,28,SAN LUIS POTOSI ,972,C12,729,136,200,35,5,11,10,15,13,0,425,8,433,164,PAN_PNA
6,28,SAN LUIS POTOSI ,972,C13,729,145,170,26,8,5,8,11,17,0,390,7,397,173,PAN_PNA
6,28,SAN LUIS POTOSI ,972,C14,729,150,188,33,9,2,15,15,17,0,429,10,439,182,PAN_PNA
6,28,SAN LUIS POTOSI ,972,C15,729,100,224,36,5,3,10,13,16,0,407,17,424,129,PAN_PNA
6,28,SAN LUIS POTOSI ,972,C16,729,135,174,38,3,6,17,8,19,0,400,11,411,162,PAN_PNA
6,28,SAN LUIS POTOSI ,972,C17,729,109,205,36,8,4,10,11,14,0,397,12,409,134,PAN_PNA
6,28,SAN LUIS POTOSI ,972,C18,729,131,194,31,5,7,16,13,19,0,416,10,426,163,PAN_PNA
6,28,SAN LUIS POTOSI ,972,C19,729,131,187,34,3,7,4,12,14,0,392,12,404,157,PAN_PNA
6,28,SAN LUIS POTOSI ,972,C20,729,149,222,24,3,5,13,13,17,0,446,9,455,179,PAN_PNA
6,28,SAN LUIS POTOSI ,976,B01,678,134,182,36,5,6,12,11,9,0,395,15,410,154,PAN_PNA
6,28,SAN LUIS POTOSI ,976,C01,678,123,196,38,5,4,7,13,14,0,400,19,419,150,PAN_PNA
6,28,SAN LUIS POTOSI ,976,C02,678,148,194,40,5,5,9,7,12,0,420,15,435,167,PAN_PNA
6,28,SAN LUIS POTOSI ,976,C03,678,147,184,40,7,7,11,5,14,0,415,11,426,166,PAN_PNA
6,28,SAN LUIS POTOSI ,976,C04,677,135,192,34,15,7,8,11,10,0,412,11,423,156,PAN_PNA
6,28,SAN LUIS POTOSI ,977,B01,581,76,139,20,6,4,10,13,5,0,273,7,280,94,PAN_PNA
6,28,SAN LUIS POTOSI ,977,C01,580,82,166,35,7,7,6,4,10,0,317,12,329,96,PAN_PNA
6,28,SAN LUIS POTOSI ,977,C02,580,79,110,19,5,2,8,10,5,0,238,6,244,94,PAN_PNA
6,28,SAN LUIS POTOSI ,977,C03,580,99,136,19,5,4,12,6,10,0,291,14,305,115,PAN_PNA
6,28,SAN LUIS POTOSI ,977,E01,552,113,166,32,2,4,9,13,9,0,348,14,362,135,PAN_PNA
6,28,SAN LUIS POTOSI ,977,E1C1,552,102,173,19,6,2,12,11,14,0,339,4,343,127,PAN_PNA
6,28,SAN LUIS POTOSI ,977,E1C2,551,119,128,40,8,4,5,8,19,0,331,8,339,146,PAN_PNA
6,28,SAN LUIS POTOSI ,978,B01,682,113,160,27,7,8,10,11,22,0,358,18,376,146,PAN_PNA
6,28,SAN LUIS POTOSI ,979,B01,608,98,141,20,5,5,5,3,7,0,284,25,309,108,PAN_PNA
6,28,SAN LUIS POTOSI ,979,C01,608,80,116,23,2,3,4,9,16,0,253,11,264,105,PAN_PNA
6,28,SAN LUIS POTOSI ,980,B01,483,63,106,12,11,4,4,3,7,0,210,10,220,73,PAN_PNA
6,28,SAN LUIS POTOSI ,980,C01,482,62,121,20,3,2,3,5,13,0,229,11,240,80,PAN_PNA
6,28,SAN LUIS POTOSI ,981,B01,705,82,169,18,11,3,9,9,15,0,316,10,326,106,PAN_PNA
6,28,SAN LUIS POTOSI ,990,B01,638,136,184,32,5,10,11,7,19,0,404,14,418,162,PAN_PNA
6,28,SAN LUIS POTOSI ,991,B01,454,109,138,24,4,6,4,5,14,0,304,17,321,128,PAN_PNA
6,28,SAN LUIS POTOSI ,992,B01,588,112,144,23,6,3,10,7,13,0,318,16,334,132,PAN_PNA
6,28,SAN LUIS POTOSI ,993,B01,572,106,153,30,7,1,11,11,9,0,328,18,346,126,PAN_PNA
6,28,SAN LUIS POTOSI ,994,B01,495,99,113,18,5,6,3,8,7,0,259,12,271,114,PAN_PNA
6,28,SAN LUIS POTOSI ,994,C01,494,85,129,36,3,10,5,7,13,0,288,11,299,105,PAN_PNA
6,28,SAN LUIS POTOSI ,995,B01,714,129,207,31,5,0,15,12,14,0,413,21,434,155,PAN_PNA
6,28,SAN LUIS POTOSI ,1008,B01,621,93,208,35,7,8,8,10,9,0,378,19,397,112,PAN_PNA
6,28,SAN LUIS POTOSI ,1009,B01,586,136,191,30,7,8,11,6,17,0,406,22,428,159,PAN_PNA
6,28,SAN LUIS POTOSI ,1010,B01,392,43,65,10,5,5,6,5,4,0,143,7,150,52,PAN_PNA
6,28,SAN LUIS POTOSI ,1011,B01,575,109,169,28,4,9,7,7,9,0,342,11,353,125,PAN_PNA
6,28,SAN LUIS POTOSI ,1012,B01,521,85,136,23,7,2,8,9,9,0,279,10,289,103,PAN_PNA
6,28,SAN LUIS POTOSI ,1012,C01,520,100,127,20,2,6,3,5,6,0,269,22,291,111,PAN_PNA
6,28,SAN LUIS POTOSI ,1013,B01,416,72,116,17,9,3,7,8,12,0,244,7,251,92,PAN_PNA
6,28,SAN LUIS POTOSI ,1013,C01,415,71,117,17,3,10,4,5,13,0,240,16,256,89,PAN_PNA
6,28,SAN LUIS POTOSI ,1014,B01,430,80,105,23,7,4,3,6,7,0,235,8,243,93,PAN_PNA
6,28,SAN LUIS POTOSI ,1014,C01,429,77,123,17,5,6,8,4,8,0,248,18,266,89,PAN_PNA
6,28,SAN LUIS POTOSI ,1015,B01,453,83,112,24,6,4,7,7,8,0,251,11,262,98,PAN_PNA
6,28,SAN LUIS POTOSI ,1015,C01,453,65,134,21,7,0,8,6,6,0,247,5,252,77,PAN_PNA
6,28,SAN LUIS POTOSI ,1016,B01,274,60,78,12,5,1,1,6,4,0,167,3,170,70,PAN_PNA
6,28,SAN LUIS POTOSI ,1017,B01,398,103,113,16,1,4,11,11,7,0,266,5,271,121,PAN_PNA
6,28,SAN LUIS POTOSI ,1017,C01,397,101,115,17,2,4,7,5,8,0,259,11,270,114,PAN_PNA
6,28,SAN LUIS POTOSI ,1018,B01,610,118,192,33,9,7,12,5,17,0,393,18,411,140,PAN_PNA
6,28,SAN LUIS POTOSI ,1018,C01,609,133,170,24,7,7,13,13,15,0,382,13,395,161,PAN_PNA
6,28,SAN LUIS POTOSI ,1026,B01,597,113,157,52,9,6,6,10,13,0,366,19,385,136,PAN_PNA
6,28,SAN LUIS POTOSI ,1026,C01,596,99,165,53,15,13,13,12,8,0,378,20,398,119,PAN_PNA
6,28,SAN LUIS POTOSI ,1027,B01,512,89,162,19,10,9,6,5,15,0,315,13,328,109,PAN_PNA
6,28,SAN LUIS POTOSI ,1027,C01,511,92,131,20,6,7,11,8,11,0,286,13,299,111,PAN_PNA
6,28,SAN LUIS POTOSI ,1028,B01,750,128,218,34,10,4,12,15,8,0,429,17,446,151,PAN_PNA
6,28,SAN LUIS POTOSI ,1028,C01,749,146,197,25,3,5,10,13,17,0,416,17,433,176,PAN_PNA
6,28,SAN LUIS POTOSI ,1029,B01,603,111,147,18,11,4,9,10,6,0,316,18,334,127,PAN_PNA
6,28,SAN LUIS POTOSI ,1029,C01,603,94,135,21,8,8,6,11,11,0,294,10,304,116,PAN_PNA
6,28,SAN LUIS POTOSI ,1030,B01,540,123,109,23,7,8,6,10,8,0,294,19,313,141,PAN_PNA
6,28,SAN LUIS POTOSI ,1030,C01,539,107,114,16,11,3,8,6,7,0,272,11,283,120,PAN_PNA
6,28,SAN LUIS POTOSI ,1031,B01,514,95,132,18,4,2,7,5,14,0,277,12,289,114,PAN_PNA
6,28,SAN LUIS POTOSI ,1031,C01,514,88,145,20,8,13,7,10,16,0,307,17,324,114,PAN_PNA
6,28,SAN LUIS POTOSI ,1031,C02,514,112,131,23,9,4,14,2,9,0,304,11,315,123,PAN_PNA
6,28,SAN LUIS POTOSI ,1032,B01,676,147,162,36,11,6,6,8,12,0,388,14,402,167,PAN_PNA
6,28,SAN LUIS POTOSI ,1032,C01,676,165,138,35,4,8,16,10,12,0,388,20,408,187,PAN_PNA
6,28,SAN LUIS POTOSI ,1033,B01,497,76,134,16,7,5,15,9,9,0,271,12,283,94,PAN_PNA
6,28,SAN LUIS POTOSI ,1033,C01,496,91,123,16,6,4,13,4,7,0,264,12,276,102,PAN_PNA
6,28,SAN LUIS POTOSI ,1034,B01,623,131,144,25,16,5,4,6,12,0,343,16,359,149,PAN_PNA
6,28,SAN LUIS POTOSI ,1034,C01,622,126,163,24,12,3,6,13,18,0,365,7,372,157,PAN_PNA
6,28,SAN LUIS POTOSI ,1035,B01,712,146,187,40,9,5,8,12,18,0,425,9,434,176,PAN_PNA
6,28,SAN LUIS POTOSI ,1035,C01,711,143,204,39,11,5,12,13,15,0,442,11,453,171,PAN_PNA
6,28,SAN LUIS POTOSI ,1036,B01,636,102,163,25,12,9,5,10,25,0,351,16,367,137,PAN_PNA
6,28,SAN LUIS POTOSI ,1036,C01,635,105,169,23,7,4,9,11,23,0,351,18,369,139,PAN_PNA
6,28,SAN LUIS POTOSI ,1043,B01,523,131,124,28,6,7,3,7,8,0,314,11,325,146,PAN_PNA
6,28,SAN LUIS POTOSI ,1043,C01,522,124,138,25,6,6,4,9,11,0,323,6,329,144,PAN_PNA
6,28,SAN LUIS POTOSI ,1044,B01,582,93,134,22,7,5,9,9,9,0,288,14,302,111,PAN_PNA
6,28,SAN LUIS POTOSI ,1044,C01,581,75,155,19,6,9,16,4,13,0,297,16,313,92,PAN_PNA
6,28,SAN LUIS POTOSI ,1045,B01,587,76,174,15,4,8,9,8,11,0,305,18,323,95,PAN_PNA
6,28,SAN LUIS POTOSI ,1045,C01,586,88,174,22,7,4,13,8,12,0,328,20,348,108,PAN_PNA
6,28,SAN LUIS POTOSI ,1045,C02,586,97,142,30,8,3,12,11,12,0,315,20,335,120,PAN_PNA
6,28,SAN LUIS POTOSI ,1045,C03,586,107,153,17,3,3,9,8,7,0,307,16,323,122,PAN_PNA
6,28,SAN LUIS POTOSI ,1046,B01,557,77,146,15,9,7,6,7,12,0,279,8,287,96,PAN_PNA
6,28,SAN LUIS POTOSI ,1046,C01,556,78,151,17,4,2,9,5,8,0,274,14,288,91,PAN_PNA
6,28,SAN LUIS POTOSI ,1047,B01,539,99,154,26,14,8,7,12,10,0,330,5,335,121,PAN_PNA
6,28,SAN LUIS POTOSI ,1047,C01,538,96,154,26,9,7,3,10,18,0,323,8,331,124,PAN_PNA
6,28,SAN LUIS POTOSI ,1048,B01,504,99,128,27,11,2,5,4,4,0,280,12,292,107,PAN_PNA
6,28,SAN LUIS POTOSI ,1048,C01,504,88,114,24,6,3,5,6,12,0,258,11,269,106,PAN_PNA
6,28,SAN LUIS POTOSI ,1048,C02,504,96,145,21,6,5,6,5,4,0,288,12,300,105,PAN_PNA
6,28,SAN LUIS POTOSI ,1049,B01,742,115,185,28,13,6,6,14,21,0,388,14,402,150,PAN_PNA
6,28,SAN LUIS POTOSI ,1049,C01,742,148,164,26,8,6,9,11,22,0,394,18,412,181,PAN_PNA
6,28,SAN LUIS POTOSI ,1050,B01,587,109,141,23,3,12,12,13,17,0,330,14,344,139,PAN_PNA
6,28,SAN LUIS POTOSI ,1050,C01,587,97,125,30,7,6,6,16,17,0,304,14,318,130,PAN_PNA
6,28,SAN LUIS POTOSI ,1050,C02,587,106,132,17,7,7,6,4,8,0,287,16,303,118,PAN_PNA
6,28,SAN LUIS POTOSI ,1051,B01,569,132,166,32,7,2,5,8,13,1,366,18,384,153,PAN_PNA
6,28,SAN LUIS POTOSI ,1051,C01,569,125,140,38,8,5,8,8,11,0,343,16,359,144,PAN_PNA
6,28,SAN LUIS POTOSI ,1051,C02,569,125,166,39,7,3,10,8,13,0,371,17,388,146,PAN_PNA
6,28,SAN LUIS POTOSI ,1052,B01,590,107,161,39,11,8,3,18,12,0,359,21,380,137,PAN_PNA
6,28,SAN LUIS POTOSI ,1052,C01,590,124,150,35,5,5,18,8,19,0,364,15,379,151,PAN_PNA
6,28,SAN LUIS POTOSI ,1053,B01,669,112,171,35,7,9,9,7,14,0,364,12,376,133,PAN_PNA
6,28,SAN LUIS POTOSI ,1053,C01,669,134,191,40,10,5,11,13,11,0,415,11,426,158,PAN_PNA
6,28,SAN LUIS POTOSI ,1053,C02,668,138,175,24,4,10,7,7,10,0,375,20,395,155,PAN_PNA
6,28,SAN LUIS POTOSI ,1054,B01,610,96,138,24,10,3,8,7,9,0,295,16,311,112,PAN_PNA
6,28,SAN LUIS POTOSI ,1054,C01,610,130,128,24,7,7,14,10,12,0,332,11,343,152,PAN_PNA
6,28,SAN LUIS POTOSI ,1055,B01,660,116,164,29,9,7,15,8,10,0,358,16,374,134,PAN_PNA
6,28,SAN LUIS POTOSI ,1055,C01,660,132,173,27,7,1,16,13,9,0,378,21,399,154,PAN_PNA
6,28,SAN LUIS POTOSI ,1055,C02,660,118,148,25,10,10,16,6,12,0,345,16,361,136,PAN_PNA
6,28,SAN LUIS POTOSI ,1055,C03,660,104,174,22,5,9,18,7,15,0,354,13,367,126,PAN_PNA
6,28,SAN LUIS POTOSI ,1056,B01,565,79,153,8,6,4,7,7,7,0,271,14,285,93,PAN_PNA
6,28,SAN LUIS POTOSI ,1056,C01,565,57,132,17,2,5,4,8,7,0,232,10,242,72,PAN_PNA
6,28,SAN LUIS POTOSI ,1056,C02,564,66,156,14,5,5,6,7,7,0,266,8,274,80,PAN_PNA
6,28,SAN LUIS POTOSI ,1057,B01,609,85,174,17,11,3,10,7,10,0,317,17,334,102,PAN_PNA
6,28,SAN LUIS POTOSI ,1057,C01,609,110,163,17,6,4,6,9,10,0,325,15,340,129,PAN_PNA
6,28,SAN LUIS POTOSI ,1057,C02,609,109,155,19,6,3,3,10,5,0,310,15,325,124,PAN_PNA
6,28,SAN LUIS POTOSI ,1058,B01,593,109,146,28,7,5,7,4,8,0,314,13,327,121,PAN_PNA
6,28,SAN LUIS POTOSI ,1058,C01,592,90,141,14,7,1,3,6,17,0,279,14,293,113,PAN_PNA
6,28,SAN LUIS POTOSI ,1058,C02,592,95,157,14,3,3,6,3,14,0,295,11,306,112,PAN_PNA
6,28,SAN LUIS POTOSI ,1059,B01,724,124,184,35,8,4,14,5,27,0,401,19,420,156,PAN_PNA
6,28,SAN LUIS POTOSI ,1059,C01,724,131,154,37,6,6,11,12,7,0,364,17,381,150,PAN_PNA
6,28,SAN LUIS POTOSI ,1059,C02,723,145,164,34,6,5,14,14,23,0,405,19,424,182,PAN_PNA
6,28,SAN LUIS POTOSI ,1060,B01,581,114,152,21,6,8,9,8,11,0,329,19,348,133,PAN_PNA
6,28,SAN LUIS POTOSI ,1060,C01,580,109,164,17,2,4,7,6,14,0,323,10,333,129,PAN_PNA
6,28,SAN LUIS POTOSI ,1060,C02,580,77,174,25,6,7,7,14,5,0,315,15,330,96,PAN_PNA
6,28,SAN LUIS POTOSI ,1061,B01,700,118,148,19,5,4,8,6,23,0,331,17,348,147,PAN_PNA
6,28,SAN LUIS POTOSI ,1061,C01,700,137,150,16,2,6,6,10,19,0,346,19,365,166,PAN_PNA
6,28,SAN LUIS POTOSI ,1061,C02,699,102,185,14,2,2,7,8,17,0,337,13,350,127,PAN_PNA
6,28,SAN LUIS POTOSI ,1062,B01,662,91,155,24,10,15,22,3,13,0,333,10,343,107,PAN_PNA
6,28,SAN LUIS POTOSI ,1062,C01,662,105,136,17,9,8,8,6,8,0,297,22,319,119,PAN_PNA
6,28,SAN LUIS POTOSI ,1062,C02,661,98,162,21,8,9,8,8,11,0,325,13,338,117,PAN_PNA
6,28,SAN LUIS POTOSI ,1063,B01,658,137,127,17,8,3,11,11,11,0,325,17,342,159,PAN_PNA
6,28,SAN LUIS POTOSI ,1063,C01,657,115,130,22,6,1,18,7,14,0,313,20,333,136,PAN_PNA
6,28,SAN LUIS POTOSI ,1063,C02,657,128,149,16,3,6,10,6,5,0,323,19,342,139,PAN_PNA
6,28,SAN LUIS POTOSI ,1064,B01,629,79,168,16,6,1,9,7,13,0,299,15,314,99,PAN_PNA
6,28,SAN LUIS POTOSI ,1064,C01,629,99,173,16,6,5,12,6,8,0,325,9,334,113,PAN_PNA
6,28,SAN LUIS POTOSI ,1065,B01,510,69,132,24,1,1,9,15,0,0,251,11,262,84,PAN_PNA
6,28,SAN LUIS POTOSI ,1065,C01,509,68,121,22,7,4,9,14,10,1,256,13,269,92,PAN_PNA
6,28,SAN LUIS POTOSI ,1066,B01,484,74,111,12,2,3,7,12,6,0,227,17,244,92,PAN_PNA
6,28,SAN LUIS POTOSI ,1066,C01,483,55,131,23,7,3,5,6,11,0,241,12,253,72,PAN_PNA
6,28,SAN LUIS POTOSI ,1067,B01,664,101,144,35,12,6,5,8,15,0,326,16,342,124,PAN_PNA
6,28,SAN LUIS POTOSI ,1067,C01,664,122,171,25,7,5,15,6,19,0,370,13,383,147,PAN_PNA
6,28,SAN LUIS POTOSI ,1068,B01,657,99,156,17,5,5,10,10,12,0,314,8,322,121,PAN_PNA
6,28,SAN LUIS POTOSI ,1068,C01,657,93,141,29,4,6,7,12,14,0,306,9,315,119,PAN_PNA
6,28,SAN LUIS POTOSI ,1068,C02,657,98,138,13,4,4,18,9,16,0,300,13,313,123,PAN_PNA
6,28,SAN LUIS POTOSI ,1068,C03,657,91,129,18,6,0,14,6,9,0,273,17,290,106,PAN_PNA
6,28,SAN LUIS POTOSI ,1068,C04,657,76,142,14,9,2,12,4,14,0,273,15,288,94,PAN_PNA
6,28,SAN LUIS POTOSI ,1068,C05,657,98,117,19,5,5,10,8,15,0,277,8,285,121,PAN_PNA
6,28,SAN LUIS POTOSI ,1068,C06,657,108,130,13,7,5,6,12,13,0,294,22,316,133,PAN_PNA
6,28,SAN LUIS POTOSI ,1068,C07,657,112,153,21,9,4,9,17,18,0,343,13,356,147,PAN_PNA
6,28,SAN LUIS POTOSI ,1069,B01,615,93,135,42,11,3,6,12,10,0,312,19,331,115,PAN_PNA
6,28,SAN LUIS POTOSI ,1069,C01,615,106,119,42,12,3,6,8,14,0,310,17,327,128,PAN_PNA
6,28,SAN LUIS POTOSI ,1069,C02,615,79,140,53,10,6,4,10,11,0,313,14,327,100,PAN_PNA
6,28,SAN LUIS POTOSI ,1069,C03,615,113,125,28,7,6,11,7,4,0,301,11,312,124,PAN_PNA
6,28,SAN LUIS POTOSI ,1070,B01,698,121,160,17,5,1,3,8,17,0,332,17,349,146,PAN_PNA
6,28,SAN LUIS POTOSI ,1070,C01,697,124,148,21,3,3,12,7,14,0,332,18,350,145,PAN_PNA
6,28,SAN LUIS POTOSI ,1070,C02,697,120,157,27,2,5,8,8,17,0,344,15,359,145,PAN_PNA
6,28,SAN LUIS POTOSI ,1071,B01,633,105,159,33,7,2,6,4,15,0,331,15,346,124,PAN_PNA
6,28,SAN LUIS POTOSI ,1071,C01,633,112,172,33,2,10,8,10,10,0,357,12,369,132,PAN_PNA
6,28,SAN LUIS POTOSI ,1072,B01,666,114,128,15,8,4,21,6,6,0,302,19,321,126,PAN_PNA
6,28,SAN LUIS POTOSI ,1072,C01,666,94,164,24,4,5,15,7,12,0,325,11,336,113,PAN_PNA
6,28,SAN LUIS POTOSI ,1072,C02,665,108,150,22,4,7,16,5,13,0,325,25,350,126,PAN_PNA
6,28,SAN LUIS POTOSI ,1073,B01,695,101,186,17,11,6,7,10,14,0,352,11,363,125,PAN_PNA
6,28,SAN LUIS POTOSI ,1073,C01,695,117,182,27,9,6,10,5,7,0,363,10,373,129,PAN_PNA
6,28,SAN LUIS POTOSI ,1073,C02,695,91,162,22,10,5,7,5,10,0,312,11,323,106,PAN_PNA
6,28,SAN LUIS POTOSI ,1073,C03,694,102,199,24,5,8,11,8,5,0,362,12,374,115,PAN_PNA
6,28,SAN LUIS POTOSI ,1073,C04,694,84,198,26,12,2,14,10,9,0,355,10,365,103,PAN_PNA
6,28,SAN LUIS POTOSI ,1073,C05,694,98,157,20,9,3,6,13,7,0,313,10,323,118,PAN_PNA
6,28,SAN LUIS POTOSI ,1073,C06,694,105,170,18,10,8,10,6,11,0,338,14,352,122,PAN_PNA
6,28,SAN LUIS POTOSI ,1073,C07,694,97,186,22,11,4,9,7,5,0,341,7,348,109,PAN_PNA
6,28,SAN LUIS POTOSI ,1073,C08,694,97,188,22,8,5,10,5,12,0,347,13,360,114,PAN_PNA
6,28,SAN LUIS POTOSI ,1073,C09,694,80,166,42,3,1,12,8,15,0,327,13,340,103,PAN_PNA
6,28,SAN LUIS POTOSI ,1073,C10,694,119,185,16,10,4,13,4,9,0,360,10,370,132,PAN_PNA
6,28,SAN LUIS POTOSI ,1073,C11,694,89,202,16,7,7,8,8,11,0,348,12,360,108,PAN_PNA
6,28,SAN LUIS POTOSI ,1073,C12,694,105,192,17,6,5,15,15,11,0,366,5,371,131,PAN_PNA
6,28,SAN LUIS POTOSI ,1074,B01,740,92,178,29,11,9,7,9,14,0,349,8,357,115,PAN_PNA
6,28,SAN LUIS POTOSI ,1074,C01,740,91,156,33,14,7,16,12,13,0,342,14,356,116,PAN_PNA
6,28,SAN LUIS POTOSI ,1074,C02,740,102,195,30,5,14,8,8,15,0,377,13,390,125,PAN_PNA
6,28,SAN LUIS POTOSI ,1074,C03,740,101,161,26,5,10,11,13,19,0,346,17,363,133,PAN_PNA
6,28,SAN LUIS POTOSI ,1074,C04,740,107,165,31,11,7,9,8,12,0,350,14,364,127,PAN_PNA
6,28,SAN LUIS POTOSI ,1074,C05,740,92,193,16,3,9,10,9,17,0,349,10,359,118,PAN_PNA
6,28,SAN LUIS POTOSI ,1074,C06,740,84,159,27,2,4,2,7,24,0,309,21,330,115,PAN_PNA
6,28,SAN LUIS POTOSI ,1074,C07,740,90,146,21,13,6,10,10,7,0,303,7,310,107,PAN_PNA
6,28,SAN LUIS POTOSI ,1074,C08,740,92,172,25,8,10,7,9,11,0,334,14,348,112,PAN_PNA
6,28,SAN LUIS POTOSI ,1074,C09,740,117,169,31,8,8,8,11,11,0,363,22,385,139,PAN_PNA
6,28,SAN LUIS POTOSI ,1074,C10,740,101,154,25,5,5,5,5,17,0,317,18,335,123,PAN_PNA
6,28,SAN LUIS POTOSI ,1074,C11,740,85,147,27,8,7,9,6,16,0,305,16,321,107,PAN_PNA
6,28,SAN LUIS POTOSI ,1074,C12,740,94,157,29,5,5,6,8,19,0,323,15,338,121,PAN_PNA
6,28,SAN LUIS POTOSI ,1074,C13,739,109,142,20,10,6,6,12,16,0,321,18,339,137,PAN_PNA
6,28,SAN LUIS POTOSI ,1074,C14,739,88,152,23,6,5,5,8,19,0,306,20,326,115,PAN_PNA
6,28,SAN LUIS POTOSI ,1075,B01,677,109,141,37,5,1,6,6,16,0,321,20,341,131,PAN_PNA
6,28,SAN LUIS POTOSI ,1075,C01,677,108,157,26,11,2,7,8,7,0,326,8,334,123,PAN_PNA
6,28,SAN LUIS POTOSI ,1075,C02,677,129,141,34,7,3,2,10,8,0,334,11,345,147,PAN_PNA
6,28,SAN LUIS POTOSI ,1075,C03,676,119,134,37,5,6,10,8,12,0,331,13,344,139,PAN_PNA
6,28,SAN LUIS POTOSI ,1075,C04,676,113,155,33,3,5,11,6,14,0,340,18,358,133,PAN_PNA
6,28,SAN LUIS POTOSI ,1075,C05,676,114,149,26,5,5,7,10,14,0,330,13,343,138,PAN_PNA
6,28,SAN LUIS POTOSI ,1075,C06,676,97,131,28,8,0,4,11,10,0,289,14,303,118,PAN_PNA
6,28,SAN LUIS POTOSI ,1075,C07,676,87,144,36,8,5,12,7,11,0,310,9,319,105,PAN_PNA
7,28,SAN LUIS POTOSI ,823,B01,535,104,170,32,2,6,10,7,14,0,345,13,358,125,PAN_PNA
7,28,SAN LUIS POTOSI ,823,C01,534,115,167,23,7,5,9,2,15,0,343,22,365,132,PAN_PNA
7,28,SAN LUIS POTOSI ,824,B01,556,129,152,26,3,2,7,10,20,0,349,9,358,159,PAN_PNA
7,28,SAN LUIS POTOSI ,824,C01,556,136,167,30,3,5,2,11,14,0,368,9,377,161,PAN_PNA
7,28,SAN LUIS POTOSI ,824,C02,555,113,134,19,4,5,10,4,9,0,298,17,315,126,PAN_PNA
7,28,SAN LUIS POTOSI ,825,B01,650,157,186,28,4,4,3,3,19,0,404,17,421,179,PAN_PNA
7,28,SAN LUIS POTOSI ,825,C01,650,139,185,26,1,5,8,5,18,0,387,22,409,162,PAN_PNA
7,28,SAN LUIS POTOSI ,826,B01,516,99,181,16,0,4,4,5,10,0,319,12,331,114,PAN_PNA
7,28,SAN LUIS POTOSI ,826,C01,516,117,147,22,4,12,4,6,9,0,321,12,333,132,PAN_PNA
7,28,SAN LUIS POTOSI ,826,C02,515,96,160,20,3,2,4,6,14,0,305,17,322,116,PAN_PNA
7,28,SAN LUIS POTOSI ,827,B01,611,139,165,29,4,5,8,9,15,0,374,19,393,163,PAN_PNA
7,28,SAN LUIS POTOSI ,827,C01,610,148,195,35,5,4,8,9,18,0,422,14,436,175,PAN_PNA
7,28,SAN LUIS POTOSI ,828,B01,739,121,193,37,7,5,11,6,10,0,390,22,412,137,PAN_PNA
7,28,SAN LUIS POTOSI ,828,C01,738,144,232,25,10,10,8,11,28,0,468,19,487,183,PAN_PNA
7,28,SAN LUIS POTOSI ,828,C02,738,133,200,32,4,3,4,9,23,0,408,20,428,165,PAN_PNA
7,28,SAN LUIS POTOSI ,829,B01,631,126,141,24,5,1,9,10,15,0,331,13,344,151,PAN_PNA
7,28,SAN LUIS POTOSI ,829,C01,631,130,118,35,3,0,2,4,21,0,313,13,326,155,PAN_PNA
7,28,SAN LUIS POTOSI ,829,C02,631,97,137,26,2,3,5,6,14,0,290,13,303,117,PAN_PNA
7,28,SAN LUIS POTOSI ,830,B01,596,117,129,12,5,5,5,7,21,0,301,15,316,145,PAN_PNA
7,28,SAN LUIS POTOSI ,830,C01,596,102,159,16,5,2,7,4,12,0,307,14,321,118,PAN_PNA
7,28,SAN LUIS POTOSI ,830,C02,595,110,138,22,3,2,7,4,13,0,299,8,307,127,PAN_PNA
7,28,SAN LUIS POTOSI ,831,B01,714,128,188,29,8,3,6,8,13,0,383,19,402,149,PAN_PNA
7,28,SAN LUIS POTOSI ,831,C01,714,102,210,26,4,3,1,6,18,0,370,20,390,126,PAN_PNA
7,28,SAN LUIS POTOSI ,832,B01,592,97,151,31,10,5,4,7,8,0,313,9,322,112,PAN_PNA
7,28,SAN LUIS POTOSI ,832,C01,591,101,169,19,6,4,2,6,20,0,327,18,345,127,PAN_PNA
7,28,SAN LUIS POTOSI ,833,B01,509,106,137,19,1,1,3,2,11,0,280,12,292,119,PAN_PNA
7,28,SAN LUIS POTOSI ,833,C01,508,104,144,14,1,2,6,7,13,0,291,24,315,124,PAN_PNA
7,28,SAN LUIS POTOSI ,833,C02,508,95,132,19,5,2,4,7,20,0,284,13,297,122,PAN_PNA
7,28,SAN LUIS POTOSI ,834,B01,581,126,166,17,2,3,1,4,13,0,332,17,349,143,PAN_PNA
7,28,SAN LUIS POTOSI ,834,C01,581,95,194,22,5,4,4,10,13,0,347,13,360,118,PAN_PNA
7,28,SAN LUIS POTOSI ,834,C02,580,82,166,14,2,4,6,13,12,0,299,19,318,107,PAN_PNA
7,28,SAN LUIS POTOSI ,835,B01,582,132,170,27,3,6,3,8,18,0,367,10,377,158,PAN_PNA
7,28,SAN LUIS POTOSI ,835,C01,582,135,170,20,5,4,3,6,16,0,359,15,374,157,PAN_PNA
7,28,SAN LUIS POTOSI ,835,C02,582,121,189,29,6,3,4,1,19,0,372,11,383,141,PAN_PNA
7,28,SAN LUIS POTOSI ,836,B01,382,73,121,12,3,1,2,9,8,0,229,10,239,90,PAN_PNA
7,28,SAN LUIS POTOSI ,836,C01,381,93,106,13,1,4,4,5,13,0,239,10,249,111,PAN_PNA
7,28,SAN LUIS POTOSI ,842,B01,513,112,117,20,7,3,3,2,13,0,277,5,282,127,PAN_PNA
7,28,SAN LUIS POTOSI ,842,C01,512,89,158,24,4,6,7,10,10,0,308,14,322,109,PAN_PNA
7,28,SAN LUIS POTOSI ,842,C02,512,106,136,19,5,4,6,4,18,0,298,16,314,128,PAN_PNA
7,28,SAN LUIS POTOSI ,843,B01,551,90,154,23,9,2,7,10,17,0,312,11,323,117,PAN_PNA
7,28,SAN LUIS POTOSI ,843,C01,551,107,162,22,5,7,8,5,17,0,333,20,353,129,PAN_PNA
7,28,SAN LUIS POTOSI ,843,C02,550,136,164,25,6,0,8,8,16,0,363,6,369,160,PAN_PNA
7,28,SAN LUIS POTOSI ,844,B01,677,175,185,38,2,2,4,10,26,0,442,10,452,211,PAN_PNA
7,28,SAN LUIS POTOSI ,844,C01,676,155,182,26,3,2,5,20,17,0,410,13,423,192,PAN_PNA
7,28,SAN LUIS POTOSI ,844,C02,676,156,199,25,5,1,2,6,23,0,417,12,429,185,PAN_PNA
7,28,SAN LUIS POTOSI ,844,C03,676,148,212,19,7,2,6,11,11,0,416,11,427,170,PAN_PNA
7,28,SAN LUIS POTOSI ,845,B01,494,91,160,27,1,2,2,6,8,0,297,7,304,105,PAN_PNA
7,28,SAN LUIS POTOSI ,845,C01,493,89,179,33,3,4,3,8,14,0,333,9,342,111,PAN_PNA
7,28,SAN LUIS POTOSI ,846,B01,670,301,170,24,1,3,0,1,19,0,519,11,530,321,PAN_PNA
7,28,SAN LUIS POTOSI ,846,C01,670,265,172,9,2,3,5,1,23,0,480,5,485,289,PAN_PNA
7,28,SAN LUIS POTOSI ,846,C02,669,238,183,10,5,6,7,5,33,0,487,9,496,276,PAN_PNA
7,28,SAN LUIS POTOSI ,847,B01,583,83,149,19,7,4,2,8,16,0,288,17,305,107,PAN_PNA
7,28,SAN LUIS POTOSI ,847,C01,583,94,159,21,6,4,4,5,13,0,306,16,322,112,PAN_PNA
7,28,SAN LUIS POTOSI ,847,C02,583,77,150,32,7,1,8,8,13,0,296,6,302,98,PAN_PNA
7,28,SAN LUIS POTOSI ,847,C03,583,97,181,24,1,4,7,17,13,0,344,10,354,127,PAN_PNA
7,28,SAN LUIS POTOSI ,848,B01,512,108,154,23,2,2,5,5,29,0,328,14,342,142,PAN_PNA
7,28,SAN LUIS POTOSI ,848,C01,512,95,125,20,8,5,9,7,14,0,283,4,287,116,PAN_PNA
7,28,SAN LUIS POTOSI ,848,C02,512,113,139,23,4,4,9,7,12,0,311,7,318,132,PAN_PNA
7,28,SAN LUIS POTOSI ,857,B01,604,166,193,29,7,4,9,7,19,0,434,13,447,192,PAN_PNA
7,28,SAN LUIS POTOSI ,857,C01,604,152,178,20,8,2,3,9,19,0,391,16,407,180,PAN_PNA
7,28,SAN LUIS POTOSI ,857,C02,604,135,152,15,17,6,2,2,10,0,339,12,351,147,PAN_PNA
7,28,SAN LUIS POTOSI ,857,C03,604,143,181,23,9,4,7,7,13,0,387,14,401,163,PAN_PNA
7,28,SAN LUIS POTOSI ,858,B01,638,213,162,30,8,2,1,9,28,0,453,9,462,250,PAN_PNA
7,28,SAN LUIS POTOSI ,858,C01,637,204,184,27,5,3,2,7,18,0,450,16,466,229,PAN_PNA
7,28,SAN LUIS POTOSI ,859,B01,605,106,152,27,4,3,3,7,13,0,315,22,337,126,PAN_PNA
7,28,SAN LUIS POTOSI ,859,C01,604,117,151,17,3,1,4,5,14,0,312,18,330,136,PAN_PNA
7,28,SAN LUIS POTOSI ,860,B01,555,94,152,32,3,3,5,4,10,0,303,9,312,108,PAN_PNA
7,28,SAN LUIS POTOSI ,860,C01,554,124,131,25,0,2,1,0,14,0,297,7,304,138,PAN_PNA
7,28,SAN LUIS POTOSI ,861,B01,666,135,178,33,5,5,4,7,20,0,387,16,403,162,PAN_PNA
7,28,SAN LUIS POTOSI ,862,B01,718,131,196,25,9,7,9,8,19,0,404,15,419,158,PAN_PNA
7,28,SAN LUIS POTOSI ,865,B01,571,158,157,37,5,4,3,1,15,0,380,12,392,174,PAN_PNA
7,28,SAN LUIS POTOSI ,865,C01,570,142,168,27,5,2,5,6,26,0,381,11,392,174,PAN_PNA
7,28,SAN LUIS POTOSI ,866,B01,663,116,173,25,5,3,8,8,15,0,353,21,374,139,PAN_PNA
7,28,SAN LUIS POTOSI ,866,C01,662,131,174,23,6,3,4,7,14,1,363,25,388,152,PAN_PNA
7,28,SAN LUIS POTOSI ,867,B01,626,136,190,21,8,3,11,8,23,0,400,10,410,167,PAN_PNA
7,28,SAN LUIS POTOSI ,867,C01,626,132,173,23,6,3,5,4,15,0,361,11,372,151,PAN_PNA
7,28,SAN LUIS POTOSI ,868,B01,684,218,187,32,4,5,6,6,29,0,487,14,501,253,PAN_PNA
7,28,SAN LUIS POTOSI ,868,C01,684,245,160,21,3,7,4,4,29,0,473,15,488,278,PAN_PNA
7,28,SAN LUIS POTOSI ,869,B01,469,191,104,17,0,6,4,3,24,0,349,5,354,218,PAN_PNA
7,28,SAN LUIS POTOSI ,869,C01,468,184,125,15,4,1,1,1,14,0,345,6,351,199,PAN_PNA
7,28,SAN LUIS POTOSI ,870,B01,521,137,175,28,1,7,4,6,13,0,371,9,380,156,PAN_PNA
7,28,SAN LUIS POTOSI ,870,C01,521,128,137,24,6,1,2,4,13,0,315,12,327,145,PAN_PNA
7,28,SAN LUIS POTOSI ,870,C02,521,155,139,16,3,3,3,1,17,0,337,14,351,173,PAN_PNA
7,28,SAN LUIS POTOSI ,871,B01,614,130,182,44,5,3,5,7,15,0,391,14,405,152,PAN_PNA
7,28,SAN LUIS POTOSI ,871,C01,613,133,186,35,8,0,2,7,22,0,393,12,405,162,PAN_PNA
7,28,SAN LUIS POTOSI ,872,B01,430,77,102,26,5,2,4,5,8,0,229,22,251,90,PAN_PNA
7,28,SAN LUIS POTOSI ,872,C01,430,97,99,24,2,1,6,8,8,0,245,0,245,113,PAN_PNA
7,28,SAN LUIS POTOSI ,881,B01,509,92,125,23,3,2,5,7,9,0,266,13,279,108,PAN_PNA
7,28,SAN LUIS POTOSI ,882,B01,457,72,117,30,7,3,4,11,9,0,253,19,272,92,PAN_PNA
7,28,SAN LUIS POTOSI ,883,B01,483,179,116,11,1,2,7,3,30,0,349,13,362,212,PAN_PNA
7,28,SAN LUIS POTOSI ,883,C01,482,169,130,18,1,1,4,3,24,0,350,4,354,196,PAN_PNA
7,28,SAN LUIS POTOSI ,884,B01,639,263,163,13,2,1,2,4,26,0,474,13,487,293,PAN_PNA
7,28,SAN LUIS POTOSI ,884,C01,638,233,159,23,6,5,3,5,25,0,459,11,470,263,PAN_PNA
7,28,SAN LUIS POTOSI ,885,B01,608,216,176,23,0,1,1,5,26,0,448,16,464,247,PAN_PNA
7,28,SAN LUIS POTOSI ,885,C01,607,228,150,22,1,1,2,6,19,0,429,15,444,253,PAN_PNA
7,28,SAN LUIS POTOSI ,885,C02,607,217,152,29,4,3,4,4,22,0,435,18,453,243,PAN_PNA
7,28,SAN LUIS POTOSI ,886,B01,632,220,159,26,3,5,8,5,16,0,442,10,452,241,PAN_PNA
7,28,SAN LUIS POTOSI ,886,C01,632,238,157,18,3,2,4,4,20,0,446,9,455,262,PAN_PNA
7,28,SAN LUIS POTOSI ,887,B01,402,160,93,16,0,4,2,3,19,0,297,6,303,182,PAN_PNA
7,28,SAN LUIS POTOSI ,887,C01,401,145,100,17,3,2,1,2,17,0,287,7,294,164,PAN_PNA
7,28,SAN LUIS POTOSI ,888,B01,571,160,139,23,1,2,5,7,34,0,371,14,385,201,PAN_PNA
7,28,SAN LUIS POTOSI ,888,C01,571,152,163,15,1,1,3,2,23,0,360,17,377,177,PAN_PNA
7,28,SAN LUIS POTOSI ,889,B01,389,128,80,23,3,0,0,4,22,0,260,14,274,154,PAN_PNA
7,28,SAN LUIS POTOSI ,889,C01,389,112,112,22,6,1,3,4,10,0,270,5,275,126,PAN_PNA
7,28,SAN LUIS POTOSI ,890,B01,641,226,147,27,1,2,5,8,23,0,439,16,455,257,PAN_PNA
7,28,SAN LUIS POTOSI ,890,C01,640,201,143,36,1,1,6,2,22,0,412,12,424,225,PAN_PNA
7,28,SAN LUIS POTOSI ,891,B01,593,180,139,43,6,2,7,7,16,0,400,8,408,203,PAN_PNA
7,28,SAN LUIS POTOSI ,892,B01,205,40,65,15,3,3,3,2,3,0,134,4,138,45,PAN_PNA
7,28,SAN LUIS POTOSI ,893,B01,259,66,70,17,5,1,3,3,3,0,168,3,171,72,PAN_PNA
7,28,SAN LUIS POTOSI ,903,B01,715,186,157,30,6,10,4,8,41,0,442,20,462,235,PAN_PNA
7,28,SAN LUIS POTOSI ,904,B01,463,96,113,28,7,1,5,4,14,0,268,14,282,114,PAN_PNA
7,28,SAN LUIS POTOSI ,904,C01,462,138,124,19,2,1,5,3,14,0,306,18,324,155,PAN_PNA
7,28,SAN LUIS POTOSI ,905,B01,554,165,161,23,3,8,2,7,18,0,387,6,393,190,PAN_PNA
7,28,SAN LUIS POTOSI ,906,B01,681,216,182,50,3,3,7,6,16,0,483,13,496,238,PAN_PNA
7,28,SAN LUIS POTOSI ,906,C01,680,185,182,30,4,5,3,6,23,0,438,10,448,214,PAN_PNA
7,28,SAN LUIS POTOSI ,907,B01,517,172,136,19,5,0,6,5,19,0,362,9,371,196,PAN_PNA
7,28,SAN LUIS POTOSI ,907,C01,516,136,134,22,0,2,2,3,28,0,327,7,334,167,PAN_PNA
7,28,SAN LUIS POTOSI ,907,C01,516,164,131,17,5,2,3,2,22,0,346,2,348,188,PAN_PNA
7,28,SAN LUIS POTOSI ,908,B01,452,165,103,23,1,1,2,11,16,0,322,8,330,192,PAN_PNA
7,28,SAN LUIS POTOSI ,908,C01,452,144,126,19,2,7,2,17,19,0,336,11,347,180,PAN_PNA
7,28,SAN LUIS POTOSI ,909,B01,647,224,170,27,3,2,5,6,13,0,450,14,464,243,PAN_PNA
7,28,SAN LUIS POTOSI ,910,B01,622,248,116,26,2,2,3,3,33,0,433,11,444,284,PAN_PNA
7,28,SAN LUIS POTOSI ,910,C01,621,228,131,31,1,2,4,5,21,0,423,16,439,254,PAN_PNA
7,28,SAN LUIS POTOSI ,911,B01,640,277,131,31,3,2,2,6,25,0,477,7,484,308,PAN_PNA
7,28,SAN LUIS POTOSI ,912,B01,425,166,116,10,0,3,6,6,7,0,314,12,326,179,PAN_PNA
7,28,SAN LUIS POTOSI ,912,C01,425,150,106,16,1,1,6,3,19,0,302,8,310,172,PAN_PNA
7,28,SAN LUIS POTOSI ,913,B01,719,283,162,22,2,3,1,3,30,0,506,10,516,316,PAN_PNA
7,28,SAN LUIS POTOSI ,913,C01,719,268,186,22,6,0,0,3,34,0,519,14,533,305,PAN_PNA
7,28,SAN LUIS POTOSI ,914,B01,663,269,150,19,1,5,8,4,17,0,473,8,481,290,PAN_PNA
7,28,SAN LUIS POTOSI ,914,C01,663,255,172,26,1,4,7,5,20,0,490,5,495,280,PAN_PNA
7,28,SAN LUIS POTOSI ,915,B01,563,216,140,17,1,1,3,2,13,0,393,13,406,231,PAN_PNA
7,28,SAN LUIS POTOSI ,915,C01,563,173,158,15,1,2,3,4,25,0,381,16,397,202,PAN_PNA
7,28,SAN LUIS POTOSI ,916,B01,597,183,183,27,5,3,1,4,23,0,429,12,441,210,PAN_PNA
7,28,SAN LUIS POTOSI ,916,C01,597,144,170,33,5,8,9,5,24,0,398,15,413,173,PAN_PNA
7,28,SAN LUIS POTOSI ,917,B01,512,137,161,17,4,5,3,4,16,0,347,5,352,157,PAN_PNA
7,28,SAN LUIS POTOSI ,918,B01,535,128,142,34,3,9,4,3,19,0,342,18,360,150,PAN_PNA
7,28,SAN LUIS POTOSI ,928,B01,466,123,124,17,1,17,5,4,7,0,298,11,309,134,PAN_PNA
7,28,SAN LUIS POTOSI ,929,B01,677,292,179,22,2,2,5,4,22,0,528,14,542,318,PAN_PNA
7,28,SAN LUIS POTOSI ,929,C01,677,266,175,14,1,6,4,1,26,0,493,12,505,293,PAN_PNA
7,28,SAN LUIS POTOSI ,930,B01,657,275,156,20,3,2,3,4,21,0,484,14,498,300,PAN_PNA
7,28,SAN LUIS POTOSI ,982,B01,679,254,164,20,4,3,1,8,16,0,470,9,479,278,PAN_PNA
7,28,SAN LUIS POTOSI ,982,C01,678,249,155,19,4,4,6,3,20,0,460,7,467,272,PAN_PNA
7,28,SAN LUIS POTOSI ,983,B01,637,270,170,20,1,2,4,3,20,0,490,10,500,293,PAN_PNA
7,28,SAN LUIS POTOSI ,983,C01,636,231,185,16,3,2,4,5,20,0,466,4,470,256,PAN_PNA
7,28,SAN LUIS POTOSI ,983,C02,636,263,164,14,2,1,2,4,20,0,470,8,478,287,PAN_PNA
7,28,SAN LUIS POTOSI ,984,B01,635,263,152,25,1,3,4,6,19,0,473,10,483,288,PAN_PNA
7,28,SAN LUIS POTOSI ,984,C01,635,255,153,28,2,0,5,3,23,0,469,7,476,281,PAN_PNA
7,28,SAN LUIS POTOSI ,984,C02,634,271,146,25,3,6,5,1,24,0,481,9,490,296,PAN_PNA
7,28,SAN LUIS POTOSI ,985,B01,542,145,120,32,4,8,7,12,28,0,356,21,377,185,PAN_PNA
7,28,SAN LUIS POTOSI ,985,C01,542,148,154,31,4,0,4,5,21,0,367,22,389,174,PAN_PNA
7,28,SAN LUIS POTOSI ,986,B01,621,183,161,38,8,3,13,6,14,0,426,14,440,203,PAN_PNA
7,28,SAN LUIS POTOSI ,987,B01,442,92,149,28,2,7,6,3,12,0,299,9,308,107,PAN_PNA
7,28,SAN LUIS POTOSI ,987,C01,442,124,118,30,2,8,7,6,14,0,309,9,318,144,PAN_PNA
7,28,SAN LUIS POTOSI ,988,B01,422,72,116,15,5,2,7,5,11,0,233,7,240,88,PAN_PNA
7,28,SAN LUIS POTOSI ,988,C01,421,65,114,17,3,3,3,6,8,0,219,8,227,79,PAN_PNA
7,28,SAN LUIS POTOSI ,989,B01,385,95,125,30,1,3,5,11,8,0,278,11,289,114,PAN_PNA
7,28,SAN LUIS POTOSI ,989,C01,385,109,100,23,5,8,5,4,20,0,274,10,284,133,PAN_PNA
7,28,SAN LUIS POTOSI ,996,B01,511,80,122,28,7,5,6,4,13,0,265,13,278,97,PAN_PNA
7,28,SAN LUIS POTOSI ,996,C01,510,93,135,16,4,3,3,4,11,0,269,17,286,108,PAN_PNA
7,28,SAN LUIS POTOSI ,997,B01,575,127,185,38,2,3,5,7,16,0,383,27,410,150,PAN_PNA
7,28,SAN LUIS POTOSI ,997,C01,574,135,189,36,6,2,7,5,24,0,404,9,413,164,PAN_PNA
7,28,SAN LUIS POTOSI ,998,B01,544,154,146,24,6,3,3,4,18,0,358,10,368,176,PAN_PNA
7,28,SAN LUIS POTOSI ,998,C01,544,150,132,27,2,6,3,7,25,0,352,11,363,182,PAN_PNA
7,28,SAN LUIS POTOSI ,998,C02,544,144,167,13,3,3,4,6,15,0,355,12,367,165,PAN_PNA
7,28,SAN LUIS POTOSI ,999,C03,633,239,158,25,3,1,4,6,16,0,452,14,466,261,PAN_PNA
7,28,SAN LUIS POTOSI ,999,B01,633,213,169,25,1,7,5,9,26,0,455,9,464,248,PAN_PNA
7,28,SAN LUIS POTOSI ,999,C01,633,200,168,20,5,3,5,2,24,0,427,18,445,226,PAN_PNA
7,28,SAN LUIS POTOSI ,1000,B01,565,249,129,14,1,0,5,3,8,0,409,9,418,260,PAN_PNA
7,28,SAN LUIS POTOSI ,1000,C01,564,267,124,17,1,2,7,3,13,0,434,8,442,283,PAN_PNA
7,28,SAN LUIS POTOSI ,1000,C02,564,216,141,15,3,3,5,5,20,0,408,16,424,241,PAN_PNA
7,28,SAN LUIS POTOSI ,1001,B01,519,162,133,21,5,2,6,2,14,0,345,8,353,178,PAN_PNA
7,28,SAN LUIS POTOSI ,1001,C01,518,164,128,27,6,2,6,5,11,0,349,14,363,180,PAN_PNA
7,28,SAN LUIS POTOSI ,1001,C02,518,168,153,18,5,5,6,0,18,0,373,13,386,186,PAN_PNA
7,28,SAN LUIS POTOSI ,1002,B01,429,116,139,16,3,4,5,1,7,0,291,15,306,124,PAN_PNA
7,28,SAN LUIS POTOSI ,1002,C01,429,126,110,14,5,2,1,3,18,0,279,10,289,147,PAN_PNA
7,28,SAN LUIS POTOSI ,1003,B01,533,82,164,24,2,3,2,9,8,1,295,8,303,99,PAN_PNA
7,28,SAN LUIS POTOSI ,1004,B01,641,234,171,32,5,0,2,6,16,0,466,9,475,256,PAN_PNA
7,28,SAN LUIS POTOSI ,1004,C01,641,249,146,25,3,3,3,10,25,0,464,13,477,284,PAN_PNA
7,28,SAN LUIS POTOSI ,1005,B01,451,140,135,23,5,4,8,3,17,0,335,13,348,160,PAN_PNA
7,28,SAN LUIS POTOSI ,1005,C01,451,155,120,16,5,6,6,4,10,0,322,3,325,169,PAN_PNA
7,28,SAN LUIS POTOSI ,1006,B01,448,101,133,24,6,1,3,4,12,0,284,2,286,117,PAN_PNA
7,28,SAN LUIS POTOSI ,1006,C01,447,85,133,17,2,2,4,5,8,0,256,14,270,98,PAN_PNA
7,28,SAN LUIS POTOSI ,1007,B01,448,85,152,16,4,5,6,7,9,0,284,14,298,101,PAN_PNA
7,28,SAN LUIS POTOSI ,1007,C01,447,88,113,29,5,9,6,7,8,0,265,11,276,103,PAN_PNA
7,28,SAN LUIS POTOSI ,1019,B01,636,157,209,36,4,5,8,8,15,0,442,10,452,180,PAN_PNA
7,28,SAN LUIS POTOSI ,1019,C01,636,146,200,47,6,4,3,10,21,0,437,20,457,177,PAN_PNA
7,28,SAN LUIS POTOSI ,1020,B01,586,122,125,33,5,3,4,4,21,0,317,16,333,147,PAN_PNA
7,28,SAN LUIS POTOSI ,1020,C01,586,126,150,39,7,6,3,11,14,0,356,14,370,151,PAN_PNA
7,28,SAN LUIS POTOSI ,1021,B01,603,157,204,30,4,4,4,5,15,0,423,15,438,177,PAN_PNA
7,28,SAN LUIS POTOSI ,1021,C01,603,170,200,26,6,8,6,9,20,11,456,0,456,199,PAN_PNA
7,28,SAN LUIS POTOSI ,1022,B01,507,173,135,15,3,5,4,8,18,0,361,4,365,199,PAN_PNA
7,28,SAN LUIS POTOSI ,1022,C01,507,180,143,18,3,3,3,5,21,0,376,8,384,206,PAN_PNA
7,28,SAN LUIS POTOSI ,1022,C02,506,196,105,21,2,8,3,8,13,0,356,15,371,217,PAN_PNA
7,28,SAN LUIS POTOSI ,1023,B01,750,178,196,12,4,4,6,7,15,0,422,10,432,200,PAN_PNA
7,28,SAN LUIS POTOSI ,1023,C01,750,229,193,21,7,3,3,4,11,0,471,7,478,244,PAN_PNA
7,28,SAN LUIS POTOSI ,1023,C02,750,172,191,25,9,3,7,4,13,0,424,13,437,189,PAN_PNA
7,28,SAN LUIS POTOSI ,1023,C03,750,162,208,29,3,5,9,12,12,0,440,14,454,186,PAN_PNA
7,28,SAN LUIS POTOSI ,1023,C04,749,198,205,24,8,4,6,8,21,0,474,16,490,227,PAN_PNA
7,28,SAN LUIS POTOSI ,1024,B01,518,145,156,26,4,5,5,8,14,0,363,8,371,167,PAN_PNA
7,28,SAN LUIS POTOSI ,1024,C01,518,121,159,12,5,4,17,3,14,0,335,12,347,138,PAN_PNA
7,28,SAN LUIS POTOSI ,1025,B01,472,96,146,18,7,6,5,12,12,0,302,14,316,120,PAN_PNA
7,28,SAN LUIS POTOSI ,1025,C01,472,114,135,31,8,6,3,4,14,0,315,6,321,132,PAN_PNA
7,28,SAN LUIS POTOSI ,1037,B01,576,154,160,50,5,3,5,6,18,0,401,14,415,178,PAN_PNA
7,28,SAN LUIS POTOSI ,1037,C01,575,135,178,32,8,4,6,4,11,0,378,15,393,150,PAN_PNA
7,28,SAN LUIS POTOSI ,1038,B01,456,109,147,21,8,7,11,12,14,0,329,5,334,135,PAN_PNA
7,28,SAN LUIS POTOSI ,1038,C01,455,128,123,21,6,5,9,7,15,0,314,20,334,150,PAN_PNA
7,28,SAN LUIS POTOSI ,1039,B01,700,288,146,25,2,5,5,2,16,0,489,5,494,306,PAN_PNA
7,28,SAN LUIS POTOSI ,1039,C01,699,221,178,27,1,0,4,9,20,0,460,12,472,250,PAN_PNA
7,28,SAN LUIS POTOSI ,1039,C02,699,246,167,42,2,4,5,4,27,0,497,9,506,277,PAN_PNA
7,28,SAN LUIS POTOSI ,1039,C03,699,239,169,21,2,0,5,4,16,0,456,13,469,259,PAN_PNA
7,28,SAN LUIS POTOSI ,1039,C04,699,250,162,38,2,4,7,7,15,0,485,10,495,272,PAN_PNA
7,28,SAN LUIS POTOSI ,1039,C05,699,286,160,23,5,6,0,6,21,0,507,7,514,313,PAN_PNA
7,28,SAN LUIS POTOSI ,1039,C06,699,280,163,16,3,4,10,9,12,0,497,10,507,301,PAN_PNA
7,28,SAN LUIS POTOSI ,1039,C07,699,235,173,24,1,8,6,4,23,0,474,7,481,262,PAN_PNA
7,28,SAN LUIS POTOSI ,1039,C08,699,262,174,22,6,6,3,4,13,0,490,7,497,279,PAN_PNA
7,28,SAN LUIS POTOSI ,1040,B01,517,155,151,35,6,4,2,4,16,0,373,12,385,175,PAN_PNA
7,28,SAN LUIS POTOSI ,1040,C01,516,141,137,46,5,1,7,5,14,0,356,13,369,160,PAN_PNA
7,28,SAN LUIS POTOSI ,1040,C02,516,158,159,29,3,3,6,4,14,0,376,4,380,176,PAN_PNA
7,28,SAN LUIS POTOSI ,1041,B01,634,197,205,25,9,2,5,10,19,0,472,17,489,226,PAN_PNA
7,28,SAN LUIS POTOSI ,1041,C01,634,162,234,43,11,7,5,6,11,0,479,12,491,179,PAN_PNA
7,28,SAN LUIS POTOSI ,1042,B01,568,132,203,26,9,4,4,10,11,0,399,22,421,153,PAN_PNA
7,28,SAN LUIS POTOSI ,1042,C01,568,135,173,29,9,2,9,21,13,0,391,4,395,169,PAN_PNA
7,28,SAN LUIS POTOSI ,1042,C02,568,147,193,25,4,0,7,3,23,0,402,18,420,173,PAN_PNA
7,28,SAN LUIS POTOSI ,1115,B01,563,84,136,6,5,2,2,2,16,0,253,20,273,102,PAN_PNA
7,28,SAN LUIS POTOSI ,1115,C01,563,89,140,17,7,3,5,10,15,0,286,18,304,114,PAN_PNA
7,28,SAN LUIS POTOSI ,1115,C02,563,94,140,10,5,4,5,3,8,0,269,16,285,105,PAN_PNA
7,28,SAN LUIS POTOSI ,1116,B01,663,96,173,16,7,3,5,6,11,0,317,13,330,113,PAN_PNA
7,28,SAN LUIS POTOSI ,1116,C01,663,102,148,22,10,4,8,8,10,0,312,15,327,120,PAN_PNA
7,28,SAN LUIS POTOSI ,1116,C02,663,99,150,16,11,3,11,4,19,0,313,12,325,122,PAN_PNA
7,28,SAN LUIS POTOSI ,1116,C03,662,89,151,17,2,2,5,12,16,0,294,11,305,117,PAN_PNA
7,28,SAN LUIS POTOSI ,1116,C04,662,106,157,16,8,0,9,5,20,0,321,14,335,131,PAN_PNA
7,28,SAN LUIS POTOSI ,1116,C05,662,90,165,10,7,2,5,6,23,0,308,11,319,119,PAN_PNA
7,28,SAN LUIS POTOSI ,1116,C06,662,92,151,22,3,4,10,12,16,0,310,14,324,120,PAN_PNA
7,28,SAN LUIS POTOSI ,1117,B01,700,114,230,7,3,2,2,3,11,0,372,9,381,128,PAN_PNA
7,28,SAN LUIS POTOSI ,1117,C01,699,93,247,11,7,3,2,6,12,0,381,11,392,111,PAN_PNA
7,28,SAN LUIS POTOSI ,1117,C02,699,112,260,5,7,0,3,3,11,0,401,14,415,126,PAN_PNA
7,28,SAN LUIS POTOSI ,1118,B01,554,109,149,3,4,0,4,6,11,0,286,8,294,126,PAN_PNA
7,28,SAN LUIS POTOSI ,1118,C01,553,100,158,5,6,1,3,3,11,0,287,11,298,114,PAN_PNA
7,28,SAN LUIS POTOSI ,1118,C02,553,111,146,5,4,0,0,4,20,0,290,6,296,135,PAN_PNA
7,28,SAN LUIS POTOSI ,1119,B01,609,211,122,24,21,11,2,9,20,0,420,13,433,240,PAN_PNA
7,28,SAN LUIS POTOSI ,1120,B01,610,98,132,10,3,2,3,3,34,0,285,20,305,135,PAN_PNA
7,28,SAN LUIS POTOSI ,1120,C01,609,127,139,8,4,1,2,12,21,0,314,15,329,160,PAN_PNA
7,28,SAN LUIS POTOSI ,1120,C02,609,121,123,6,2,1,5,9,27,0,294,14,308,157,PAN_PNA
7,28,SAN LUIS POTOSI ,1121,B01,600,139,137,14,5,3,5,8,23,0,334,21,355,170,PAN_PNA
7,28,SAN LUIS POTOSI ,1121,C01,600,112,122,9,5,2,3,7,31,0,291,22,313,150,PAN_PNA
7,28,SAN LUIS POTOSI ,1122,B01,78,49,11,3,0,0,1,2,2,0,68,3,71,53,PAN_PNA
7,28,SAN LUIS POTOSI ,1123,B01,522,107,88,9,7,0,1,11,14,0,237,13,250,132,PAN_PNA
7,28,SAN LUIS POTOSI ,1123,C01,521,105,99,7,10,7,1,13,24,0,266,12,278,142,PAN_PNA
8,28,SAN LUIS POTOSI ,922,B01,558,126,165,32,5,7,6,15,7,0,363,12,375,148,PAN_PNA
8,28,SAN LUIS POTOSI ,922,C01,557,117,181,28,11,6,9,17,11,0,380,11,391,145,PAN_PNA
8,28,SAN LUIS POTOSI ,922,C02,557,121,163,35,9,12,11,6,15,0,372,10,382,142,PAN_PNA
8,28,SAN LUIS POTOSI ,923,B01,276,60,86,8,1,6,3,2,7,0,173,5,178,69,PAN_PNA
8,28,SAN LUIS POTOSI ,924,B01,557,137,160,32,6,3,9,4,21,0,372,9,381,162,PAN_PNA
8,28,SAN LUIS POTOSI ,924,C01,556,131,149,27,7,3,7,9,14,0,347,11,358,154,PAN_PNA
8,28,SAN LUIS POTOSI ,933,B01,380,87,97,27,5,7,10,1,8,0,242,6,248,96,PAN_PNA
8,28,SAN LUIS POTOSI ,933,C01,380,98,106,27,5,0,5,6,11,0,258,7,265,115,PAN_PNA
8,28,SAN LUIS POTOSI ,934,B01,572,119,156,35,11,9,10,10,9,0,359,13,372,138,PAN_PNA
8,28,SAN LUIS POTOSI ,934,C01,572,101,146,34,4,8,13,4,9,0,319,20,339,114,PAN_PNA
8,28,SAN LUIS POTOSI ,934,C02,571,86,178,30,12,9,9,12,8,0,344,18,362,106,PAN_PNA
8,28,SAN LUIS POTOSI ,935,B01,677,128,227,35,6,8,12,11,11,0,438,17,455,150,PAN_PNA
8,28,SAN LUIS POTOSI ,935,C01,676,147,188,36,6,13,18,8,16,0,432,15,447,171,PAN_PNA
8,28,SAN LUIS POTOSI ,936,B01,665,185,173,25,5,10,8,11,20,0,437,17,454,216,PAN_PNA
8,28,SAN LUIS POTOSI ,936,C01,665,179,189,31,3,12,13,13,14,0,454,12,466,206,PAN_PNA
8,28,SAN LUIS POTOSI ,936,C02,664,186,167,50,13,2,6,9,19,0,452,15,467,214,PAN_PNA
8,28,SAN LUIS POTOSI ,936,C03,664,182,182,42,8,2,13,9,11,0,449,15,464,202,PAN_PNA
8,28,SAN LUIS POTOSI ,936,C04,664,181,171,34,11,5,17,13,15,0,447,11,458,209,PAN_PNA
8,28,SAN LUIS POTOSI ,937,B01,670,129,206,37,10,9,12,13,17,0,433,16,449,159,PAN_PNA
8,28,SAN LUIS POTOSI ,937,C01,669,121,188,49,7,5,13,8,15,0,406,12,418,144,PAN_PNA
8,28,SAN LUIS POTOSI ,938,B01,539,98,196,36,2,4,8,9,12,0,365,13,378,119,PAN_PNA
8,28,SAN LUIS POTOSI ,938,C01,539,103,171,24,9,6,7,4,14,0,338,12,350,121,PAN_PNA
8,28,SAN LUIS POTOSI ,939,B01,503,106,159,26,8,6,7,6,3,0,321,9,330,115,PAN_PNA
8,28,SAN LUIS POTOSI ,939,C01,503,103,136,35,1,2,13,8,14,0,312,8,320,125,PAN_PNA
8,28,SAN LUIS POTOSI ,939,C02,502,112,150,25,7,8,12,10,13,0,337,4,341,135,PAN_PNA
8,28,SAN LUIS POTOSI ,940,B01,506,105,134,23,9,4,10,7,8,0,300,12,312,120,PAN_PNA
8,28,SAN LUIS POTOSI ,940,C01,506,103,138,33,9,7,8,5,11,0,314,11,325,119,PAN_PNA
8,28,SAN LUIS POTOSI ,940,C02,505,109,148,28,5,4,7,6,17,0,324,15,339,132,PAN_PNA
8,28,SAN LUIS POTOSI ,941,B01,634,108,164,26,10,14,5,6,8,0,341,13,354,122,PAN_PNA
8,28,SAN LUIS POTOSI ,941,C01,634,113,170,27,7,9,14,5,8,0,353,11,364,126,PAN_PNA
8,28,SAN LUIS POTOSI ,941,C02,634,95,166,22,7,10,10,10,8,0,328,17,345,113,PAN_PNA
8,28,SAN LUIS POTOSI ,942,B01,523,67,133,22,5,16,3,7,9,0,262,18,280,83,PAN_PNA
8,28,SAN LUIS POTOSI ,942,C01,522,78,129,26,1,9,13,7,6,0,269,13,282,91,PAN_PNA
8,28,SAN LUIS POTOSI ,942,C02,522,60,131,18,7,8,5,16,8,0,253,17,270,84,PAN_PNA
8,28,SAN LUIS POTOSI ,943,B01,707,115,140,20,6,12,11,7,23,0,334,9,343,145,PAN_PNA
8,28,SAN LUIS POTOSI ,943,C01,707,102,157,24,6,17,9,6,23,0,344,16,360,131,PAN_PNA
8,28,SAN LUIS POTOSI ,943,C02,707,123,125,25,12,18,11,8,11,0,333,16,349,142,PAN_PNA
8,28,SAN LUIS POTOSI ,943,C03,707,110,153,23,5,15,6,12,11,0,335,10,345,133,PAN_PNA
8,28,SAN LUIS POTOSI ,943,C04,706,109,138,28,4,12,12,9,12,0,324,10,334,130,PAN_PNA
8,28,SAN LUIS POTOSI ,943,C05,706,113,120,32,7,11,11,9,14,0,317,12,329,136,PAN_PNA
8,28,SAN LUIS POTOSI ,943,C06,706,108,153,20,8,9,6,4,12,0,320,15,335,124,PAN_PNA
8,28,SAN LUIS POTOSI ,943,C07,706,126,125,25,12,18,11,9,8,0,334,14,348,143,PAN_PNA
8,28,SAN LUIS POTOSI ,944,B01,681,114,169,30,3,27,9,12,9,0,373,14,387,135,PAN_PNA
8,28,SAN LUIS POTOSI ,944,C01,681,124,158,33,9,25,8,13,13,0,383,11,394,150,PAN_PNA
8,28,SAN LUIS POTOSI ,944,C02,681,90,155,25,6,24,8,11,9,0,328,25,353,110,PAN_PNA
8,28,SAN LUIS POTOSI ,944,C03,681,98,166,34,6,23,9,12,12,0,360,22,382,122,PAN_PNA
8,28,SAN LUIS POTOSI ,944,C04,680,119,171,34,8,22,18,6,14,0,392,20,412,139,PAN_PNA
8,28,SAN LUIS POTOSI ,945,B01,632,109,184,20,5,17,7,9,23,0,374,23,397,141,PAN_PNA
8,28,SAN LUIS POTOSI ,945,C01,632,97,200,14,5,18,5,14,17,0,370,13,383,128,PAN_PNA
8,28,SAN LUIS POTOSI ,946,B01,547,76,155,32,5,10,9,16,10,0,313,12,325,102,PAN_PNA
8,28,SAN LUIS POTOSI ,946,C01,547,115,126,23,4,11,2,9,11,0,301,10,311,135,PAN_PNA
8,28,SAN LUIS POTOSI ,947,B01,729,170,224,47,4,8,19,16,10,0,498,13,511,196,PAN_PNA
8,28,SAN LUIS POTOSI ,947,C01,729,168,202,57,9,9,15,14,23,0,497,11,508,205,PAN_PNA
8,28,SAN LUIS POTOSI ,947,C02,729,174,200,34,2,9,12,12,14,0,457,13,470,200,PAN_PNA
8,28,SAN LUIS POTOSI ,947,C03,728,165,208,39,10,9,13,10,15,0,469,12,481,190,PAN_PNA
8,28,SAN LUIS POTOSI ,947,C04,728,168,194,42,8,21,10,8,14,0,465,17,482,190,PAN_PNA
8,28,SAN LUIS POTOSI ,948,B01,604,145,164,36,7,3,6,14,20,0,395,11,406,179,PAN_PNA
8,28,SAN LUIS POTOSI ,948,C01,603,106,197,39,6,6,7,11,13,0,385,21,406,130,PAN_PNA
8,28,SAN LUIS POTOSI ,949,B01,444,85,122,31,6,4,6,8,4,0,266,14,280,97,PAN_PNA
8,28,SAN LUIS POTOSI ,949,C01,443,83,129,25,6,6,6,5,11,0,271,12,283,99,PAN_PNA
8,28,SAN LUIS POTOSI ,950,B01,532,111,134,27,3,8,8,13,16,0,320,11,331,140,PAN_PNA
8,28,SAN LUIS POTOSI ,950,C01,532,104,140,23,5,3,12,8,21,0,316,12,328,133,PAN_PNA
8,28,SAN LUIS POTOSI ,950,C02,532,130,154,29,7,8,6,5,19,0,358,11,369,154,PAN_PNA
8,28,SAN LUIS POTOSI ,952,B01,606,126,147,37,13,5,3,4,20,0,355,12,367,150,PAN_PNA
8,28,SAN LUIS POTOSI ,952,C01,606,139,168,33,8,9,6,11,13,0,387,6,393,163,PAN_PNA
8,28,SAN LUIS POTOSI ,953,B01,687,149,179,36,5,5,18,13,23,0,428,23,451,185,PAN_PNA
8,28,SAN LUIS POTOSI ,953,C01,686,140,205,31,8,9,12,6,20,0,431,7,438,166,PAN_PNA
8,28,SAN LUIS POTOSI ,953,C02,686,155,167,31,6,8,12,12,15,0,406,9,415,182,PAN_PNA
8,28,SAN LUIS POTOSI ,954,B01,519,88,118,18,5,18,7,10,9,0,273,8,281,107,PAN_PNA
8,28,SAN LUIS POTOSI ,954,C01,519,79,111,19,4,16,8,8,9,0,254,9,263,96,PAN_PNA
8,28,SAN LUIS POTOSI ,955,B01,665,125,145,29,6,14,10,9,9,0,347,21,368,143,PAN_PNA
8,28,SAN LUIS POTOSI ,955,C01,665,96,146,21,6,15,13,7,13,0,317,12,329,116,PAN_PNA
8,28,SAN LUIS POTOSI ,955,C02,664,97,161,25,7,14,14,12,9,0,339,18,357,118,PAN_PNA
8,28,SAN LUIS POTOSI ,955,C03,664,106,147,12,10,12,14,7,9,1,318,12,330,122,PAN_PNA
8,28,SAN LUIS POTOSI ,955,C04,664,122,139,27,7,12,14,10,10,0,341,11,352,142,PAN_PNA
8,28,SAN LUIS POTOSI ,955,C05,664,119,155,24,5,14,12,5,17,0,351,15,366,141,PAN_PNA
8,28,SAN LUIS POTOSI ,955,C06,664,121,140,24,8,13,16,8,12,0,342,9,351,141,PAN_PNA
8,28,SAN LUIS POTOSI ,955,C07,664,117,140,18,8,11,9,4,12,0,319,12,331,133,PAN_PNA
8,28,SAN LUIS POTOSI ,956,B01,617,91,144,30,4,30,6,9,10,0,324,21,345,110,PAN_PNA
8,28,SAN LUIS POTOSI ,956,C01,617,99,135,25,6,16,10,6,12,0,309,14,323,117,PAN_PNA
8,28,SAN LUIS POTOSI ,957,B01,647,106,158,32,7,21,13,6,8,0,351,10,361,120,PAN_PNA
8,28,SAN LUIS POTOSI ,957,C01,646,99,158,22,7,31,5,10,15,0,347,21,368,124,PAN_PNA
8,28,SAN LUIS POTOSI ,958,B01,682,124,183,18,4,18,7,8,11,0,373,19,392,143,PAN_PNA
8,28,SAN LUIS POTOSI ,958,C01,681,115,164,28,4,19,8,12,12,0,362,15,377,139,PAN_PNA
8,28,SAN LUIS POTOSI ,959,B01,687,170,185,27,10,6,11,14,22,0,445,15,460,206,PAN_PNA
8,28,SAN LUIS POTOSI ,959,C01,686,167,174,42,5,3,18,10,25,0,444,21,465,202,PAN_PNA
8,28,SAN LUIS POTOSI ,959,C02,686,171,182,31,5,10,3,11,23,0,436,18,454,205,PAN_PNA
8,28,SAN LUIS POTOSI ,960,B01,459,94,113,18,6,6,11,3,12,0,263,10,273,109,PAN_PNA
8,28,SAN LUIS POTOSI ,960,C01,459,113,115,22,6,10,5,9,15,0,295,11,306,137,PAN_PNA
8,28,SAN LUIS POTOSI ,961,B01,656,157,177,38,7,9,12,12,16,0,428,13,441,185,PAN_PNA
8,28,SAN LUIS POTOSI ,961,C01,655,126,159,33,9,11,17,9,24,0,388,10,398,159,PAN_PNA
8,28,SAN LUIS POTOSI ,961,C02,655,149,167,31,8,9,14,11,4,0,393,17,410,164,PAN_PNA
8,28,SAN LUIS POTOSI ,961,C03,655,130,193,42,4,4,4,11,16,0,404,14,418,157,PAN_PNA
8,28,SAN LUIS POTOSI ,961,C04,655,121,169,37,9,11,12,8,22,0,389,11,400,151,PAN_PNA
8,28,SAN LUIS POTOSI ,961,C05,655,132,181,36,7,8,20,11,15,0,410,17,427,158,PAN_PNA
8,28,SAN LUIS POTOSI ,962,B01,571,85,162,29,6,15,9,9,14,0,329,19,348,108,PAN_PNA
8,28,SAN LUIS POTOSI ,962,C01,570,97,173,22,1,16,5,4,11,0,329,7,336,112,PAN_PNA
8,28,SAN LUIS POTOSI ,963,B01,598,107,133,25,3,16,9,10,6,0,309,18,327,123,PAN_PNA
8,28,SAN LUIS POTOSI ,963,C01,598,98,115,22,3,13,14,15,19,0,299,22,321,132,PAN_PNA
8,28,SAN LUIS POTOSI ,964,B01,559,83,115,31,7,11,11,8,11,0,277,10,287,102,PAN_PNA
8,28,SAN LUIS POTOSI ,964,C01,558,88,93,29,3,16,14,6,7,0,256,13,269,101,PAN_PNA
8,28,SAN LUIS POTOSI ,965,B01,698,101,179,21,8,18,11,2,12,0,352,15,367,115,PAN_PNA
8,28,SAN LUIS POTOSI ,965,C01,698,117,156,28,5,16,13,5,14,0,354,12,366,136,PAN_PNA
8,28,SAN LUIS POTOSI ,965,C02,698,121,145,21,7,26,17,9,16,0,362,19,381,146,PAN_PNA
8,28,SAN LUIS POTOSI ,965,C03,698,109,142,32,4,24,10,6,8,0,335,14,349,123,PAN_PNA
8,28,SAN LUIS POTOSI ,965,C04,698,104,151,24,10,18,5,12,9,0,333,11,344,125,PAN_PNA
8,28,SAN LUIS POTOSI ,965,C05,698,131,142,20,9,25,12,8,18,0,365,8,373,157,PAN_PNA
8,28,SAN LUIS POTOSI ,965,C06,698,123,142,17,4,15,10,6,13,0,330,11,341,142,PAN_PNA
8,28,SAN LUIS POTOSI ,965,C07,698,96,152,28,8,15,12,9,9,0,329,11,340,114,PAN_PNA
8,28,SAN LUIS POTOSI ,965,C08,698,96,167,17,9,17,12,11,10,0,339,8,347,117,PAN_PNA
8,28,SAN LUIS POTOSI ,965,C09,698,120,146,36,9,12,15,10,11,0,359,6,365,141,PAN_PNA
8,28,SAN LUIS POTOSI ,965,C10,698,123,167,22,7,12,7,6,18,0,362,16,378,147,PAN_PNA
8,28,SAN LUIS POTOSI ,966,B01,690,138,163,27,9,18,8,6,8,0,377,14,391,152,PAN_PNA
8,28,SAN LUIS POTOSI ,966,C01,689,131,146,31,4,14,16,9,11,0,362,9,371,151,PAN_PNA
8,28,SAN LUIS POTOSI ,967,B01,714,129,183,15,9,15,12,10,22,0,395,20,415,161,PAN_PNA
8,28,SAN LUIS POTOSI ,967,C01,714,132,161,26,12,9,6,10,20,0,376,19,395,162,PAN_PNA
8,28,SAN LUIS POTOSI ,967,C02,713,132,145,35,4,13,9,9,19,0,366,22,388,160,PAN_PNA
8,28,SAN LUIS POTOSI ,967,C03,713,129,172,28,9,18,6,17,21,0,400,22,422,167,PAN_PNA
8,28,SAN LUIS POTOSI ,968,B01,556,114,137,30,7,12,27,5,14,0,346,14,360,133,PAN_PNA
8,28,SAN LUIS POTOSI ,968,C01,556,113,110,29,8,4,11,10,13,0,298,22,320,136,PAN_PNA
8,28,SAN LUIS POTOSI ,969,B01,726,161,181,37,5,8,8,10,20,0,430,9,439,191,PAN_PNA
8,28,SAN LUIS POTOSI ,969,C01,726,161,207,36,10,11,12,10,15,0,462,18,480,186,PAN_PNA
8,28,SAN LUIS POTOSI ,969,C02,726,145,192,41,7,9,7,11,18,0,430,15,445,174,PAN_PNA
8,28,SAN LUIS POTOSI ,969,C03,726,141,187,28,9,13,14,16,16,0,424,17,441,173,PAN_PNA
8,28,SAN LUIS POTOSI ,970,B01,685,148,198,45,8,0,10,11,13,0,433,19,452,172,PAN_PNA
8,28,SAN LUIS POTOSI ,970,C01,684,146,173,45,7,5,6,11,22,0,415,18,433,179,PAN_PNA
8,28,SAN LUIS POTOSI ,970,C02,684,154,186,28,9,6,7,20,16,0,426,13,439,190,PAN_PNA
8,28,SAN LUIS POTOSI ,973,B01,453,87,104,36,6,8,15,6,12,0,274,11,285,105,PAN_PNA
8,28,SAN LUIS POTOSI ,973,C01,452,71,97,35,3,8,19,5,11,0,249,15,264,87,PAN_PNA
8,28,SAN LUIS POTOSI ,974,B01,750,152,203,33,8,16,16,7,14,0,449,16,465,173,PAN_PNA
8,28,SAN LUIS POTOSI ,974,C01,749,155,178,36,2,17,11,8,10,0,417,17,434,173,PAN_PNA
8,28,SAN LUIS POTOSI ,974,C02,749,134,185,59,9,14,12,7,12,0,432,17,449,153,PAN_PNA
8,28,SAN LUIS POTOSI ,974,C03,749,148,192,30,8,8,19,14,9,0,428,13,441,171,PAN_PNA
8,28,SAN LUIS POTOSI ,975,B01,613,130,128,26,7,12,7,5,9,0,324,8,332,144,PAN_PNA
8,28,SAN LUIS POTOSI ,975,C01,612,116,136,27,5,14,9,6,17,0,330,15,345,139,PAN_PNA
8,28,SAN LUIS POTOSI ,975,C02,612,146,118,17,4,7,11,6,16,0,325,11,336,168,PAN_PNA
8,28,SAN LUIS POTOSI ,1107,B01,310,27,109,13,3,3,5,1,5,0,166,12,178,33,PAN_PNA
8,28,SAN LUIS POTOSI ,1108,B01,453,103,125,3,4,6,1,0,0,0,242,9,251,103,PAN_PNA
8,28,SAN LUIS POTOSI ,1109,B01,524,89,107,21,5,7,4,4,20,0,257,11,268,113,PAN_PNA
8,28,SAN LUIS POTOSI ,1109,C01,524,92,106,16,7,3,12,4,12,0,252,15,267,108,PAN_PNA
8,28,SAN LUIS POTOSI ,1109,C02,523,81,114,21,10,5,6,7,13,0,257,17,274,101,PAN_PNA
8,28,SAN LUIS POTOSI ,1110,B01,585,76,102,13,5,14,10,4,16,0,240,14,254,96,PAN_PNA
8,28,SAN LUIS POTOSI ,1110,C01,585,111,103,13,2,2,8,6,20,1,266,21,287,137,PAN_PNA
8,28,SAN LUIS POTOSI ,1110,C02,585,101,92,14,6,5,8,10,23,0,259,16,275,134,PAN_PNA
8,28,SAN LUIS POTOSI ,1110,C03,585,97,132,9,2,8,5,4,17,0,274,14,288,118,PAN_PNA
8,28,SAN LUIS POTOSI ,1110,E01,710,77,127,31,8,23,16,12,10,0,304,14,318,99,PAN_PNA
8,28,SAN LUIS POTOSI ,1110,E02,639,102,126,31,11,7,12,8,13,0,310,19,329,123,PAN_PNA
8,28,SAN LUIS POTOSI ,1111,B01,549,119,131,14,4,4,3,6,15,0,296,14,310,140,PAN_PNA
8,28,SAN LUIS POTOSI ,1111,C01,549,95,132,30,6,3,7,9,12,0,294,15,309,116,PAN_PNA
8,28,SAN LUIS POTOSI ,1111,C02,548,102,127,22,2,14,3,5,10,0,285,15,300,117,PAN_PNA
8,28,SAN LUIS POTOSI ,1112,B01,409,69,89,18,3,2,1,9,9,0,200,18,218,87,PAN_PNA
8,28,SAN LUIS POTOSI ,1112,C01,408,83,63,5,3,0,3,4,12,0,173,16,189,99,PAN_PNA
8,28,SAN LUIS POTOSI ,1113,B01,579,98,80,19,5,4,4,12,11,0,233,10,243,121,PAN_PNA
8,28,SAN LUIS POTOSI ,1113,C01,578,101,93,31,3,10,4,10,10,0,262,13,275,121,PAN_PNA
8,28,SAN LUIS POTOSI ,1113,C02,578,126,116,26,1,7,8,5,12,0,301,18,319,143,PAN_PNA
8,28,SAN LUIS POTOSI ,1113,C03,578,126,97,29,4,1,5,7,6,0,275,13,288,139,PAN_PNA
8,28,SAN LUIS POTOSI ,1114,B01,567,95,104,17,4,1,6,2,6,1,236,11,247,103,PAN_PNA
8,28,SAN LUIS POTOSI ,1114,C01,567,125,111,17,2,3,0,5,11,0,274,15,289,141,PAN_PNA
8,28,SAN LUIS POTOSI ,1114,C02,566,90,144,24,3,2,3,6,11,0,283,15,298,107,PAN_PNA
8,28,SAN LUIS POTOSI ,1124,B01,489,110,131,17,8,2,4,4,19,0,295,20,315,133,PAN_PNA
8,28,SAN LUIS POTOSI ,1124,C01,489,92,138,18,3,1,2,4,16,0,274,20,294,112,PAN_PNA
8,28,SAN LUIS POTOSI ,1125,B01,612,104,162,32,3,3,6,4,14,0,328,27,355,122,PAN_PNA
8,28,SAN LUIS POTOSI ,1125,C01,612,141,128,15,2,4,12,7,25,0,334,16,350,173,PAN_PNA
8,28,SAN LUIS POTOSI ,1125,C02,612,130,126,17,1,4,11,9,22,0,320,26,346,161,PAN_PNA
8,28,SAN LUIS POTOSI ,1125,C03,611,112,109,11,6,1,11,7,22,0,279,32,311,141,PAN_PNA
8,28,SAN LUIS POTOSI ,1126,B01,608,96,134,21,3,5,9,7,23,0,298,42,340,126,PAN_PNA
8,28,SAN LUIS POTOSI ,1126,C01,608,137,146,20,3,1,12,2,15,0,336,26,362,154,PAN_PNA
8,28,SAN LUIS POTOSI ,1127,B01,634,69,85,20,6,21,10,5,4,0,220,19,239,78,PAN_PNA
