Municipio,Distrito,Seccion,PAN,PRI-PT-PVEM-PEBC,PRD,PC,Nulos,Total,Lista Nominal
TECATE,VII,1,275,248,35,10,9,577,1471
TECATE,VII,2,203,255,7,16,11,492,1206
TECATE,VII,3,414,332,27,14,13,800,2011
TECATE,VII,4,274,256,23,11,9,573,1317
TECATE,VII,5,187,151,12,7,6,363,879
TECATE,VII,6,214,159,10,7,4,394,1011
TECATE,VII,7,301,263,15,12,14,605,1349
TECATE,VII,8,251,203,19,6,14,493,1259
TECATE,VII,9,397,405,48,26,21,897,2500
TECATE,VII,10,286,350,28,16,14,694,1722
TECATE,VII,11,135,196,15,15,8,369,922
TECATE,VII,12,285,266,25,17,16,609,1526
TECATE,VII,13,265,211,17,16,11,520,1402
TECATE,VII,14,259,200,13,2,7,481,1188
TECATE,VII,15,268,275,18,9,8,578,1193
TECATE,VII,16,246,214,8,8,11,487,1343
TECATE,VII,17,257,198,15,11,16,497,1327
TECATE,VII,18,278,388,36,28,15,745,2104
TECATE,VII,19,248,234,28,17,19,546,1532
TECATE,VII,20,235,242,24,14,14,529,1363
TECATE,VII,21,278,399,45,34,20,776,2168
TECATE,VII,22,211,297,72,65,25,670,2196
TECATE,VII,23,255,316,42,22,8,643,1823
TECATE,VII,24,183,235,19,22,13,472,1258
TECATE,VII,25,145,318,14,48,15,540,1372
TECATE,VII,26,197,207,25,18,6,453,1159
TECATE,VII,27,191,211,20,21,16,459,1230
TECATE,VII,28,297,368,44,66,13,788,2126
TECATE,VII,29,845,893,144,145,41,2068,5739
TECATE,VII,30,323,456,60,33,14,886,2538
TECATE,VII,31,238,443,75,28,16,800,1879
TECATE,VII,32,108,122,19,7,11,267,671
TECATE,VII,33,96,184,32,20,13,345,826
TECATE,VII,34,66,75,14,4,7,166,511
TECATE,VII,35,58,107,7,1,6,179,496
TECATE,VII,36,112,159,15,3,11,300,830
TECATE,VII,37,121,179,25,13,9,347,932
TECATE,VII,38,80,79,5,4,3,171,501
TECATE,VII,39,19,66,3,10,5,103,244
TECATE,VII,40,58,85,5,2,5,155,494
TECATE,VII,41,57,86,4,6,8,161,447
MEXICALI,I,42,48,44,8,5,1,106,914
MEXICALI,I,43,111,67,13,8,5,204,761
MEXICALI,I,44,46,43,12,6,3,110,906
MEXICALI,I,45,109,99,16,11,13,248,795
MEXICALI,I,46,92,83,16,6,4,201,833
MEXICALI,I,47,66,67,13,3,4,153,605
MEXICALI,I,48,59,70,3,26,16,174,623
MEXICALI,I,49,66,86,7,9,4,172,618
MEXICALI,I,50,133,102,18,9,6,268,856
MEXICALI,I,51,64,64,6,5,1,140,1001
MEXICALI,I,52,90,111,17,6,2,226,911
MEXICALI,I,53,97,90,21,6,13,227,814
MEXICALI,I,54,99,61,14,2,5,181,715
MEXICALI,I,55,96,108,15,5,10,234,807
MEXICALI,I,56,125,89,7,8,2,231,757
MEXICALI,I,57,98,135,18,12,18,281,954
MEXICALI,I,58,82,69,10,7,8,176,756
MEXICALI,I,59,60,69,5,8,0,142,536
MEXICALI,I,60,87,69,5,5,0,166,587
MEXICALI,I,61,58,88,7,9,6,168,652
MEXICALI,I,62,69,87,10,3,6,175,650
MEXICALI,I,63,118,124,28,17,13,300,1160
MEXICALI,I,64,108,98,9,3,6,224,809
MEXICALI,I,65,135,136,18,10,14,313,1142
MEXICALI,I,66,141,129,22,9,5,306,1073
MEXICALI,I,67,89,100,13,7,8,217,806
MEXICALI,I,68,126,117,20,9,9,281,928
MEXICALI,I,69,120,129,12,8,9,278,878
MEXICALI,I,71,59,89,15,10,6,179,761
MEXICALI,I,73,82,77,8,7,9,183,734
MEXICALI,I,74,132,78,14,9,4,237,825
MEXICALI,I,75,98,59,8,7,8,180,636
MEXICALI,I,76,110,94,16,9,11,240,867
MEXICALI,I,77,104,83,15,9,7,218,830
MEXICALI,I,78,112,113,16,7,7,255,951
MEXICALI,I,79,112,107,9,3,9,240,880
MEXICALI,I,80,135,94,18,8,4,259,869
MEXICALI,I,81,122,77,22,7,5,233,886
MEXICALI,I,82,126,148,18,2,12,306,1139
MEXICALI,I,83,139,103,15,13,8,278,1014
MEXICALI,I,84,142,128,19,11,13,313,997
MEXICALI,I,85,142,97,13,10,9,271,763
MEXICALI,I,86,121,83,10,6,12,232,830
MEXICALI,I,87,170,121,24,7,8,330,1084
MEXICALI,I,88,126,100,13,21,10,270,923
MEXICALI,I,89,205,143,23,8,11,390,1155
MEXICALI,I,90,124,121,14,5,6,270,834
MEXICALI,I,91,80,111,10,5,3,209,1045
MEXICALI,I,93,238,205,22,22,3,490,1389
MEXICALI,I,94,185,181,24,22,14,426,1376
MEXICALI,I,95,143,144,14,13,14,328,1100
MEXICALI,I,96,67,46,4,8,3,128,1012
MEXICALI,I,97,165,214,30,8,3,420,1001
MEXICALI,I,98,177,206,15,8,5,411,1028
MEXICALI,I,99,100,127,5,14,4,250,722
MEXICALI,I,100,111,131,9,7,8,266,808
MEXICALI,I,101,202,153,28,8,3,394,1190
MEXICALI,I,102,139,109,26,5,6,285,822
MEXICALI,I,103,245,262,17,7,6,537,1335
MEXICALI,I,104,201,168,25,16,8,418,1305
MEXICALI,I,105,205,158,30,20,13,426,1394
MEXICALI,I,106,174,125,13,5,13,330,1300
MEXICALI,I,107,178,153,12,11,6,360,1271
MEXICALI,I,108,307,271,29,22,17,646,2172
MEXICALI,I,109,120,186,24,4,7,341,890
MEXICALI,I,110,309,222,38,21,14,604,1857
MEXICALI,I,111,114,129,21,11,8,283,1060
MEXICALI,I,112,179,134,15,10,8,346,1254
MEXICALI,I,113,227,141,25,11,7,411,1461
MEXICALI,I,114,158,163,17,8,10,356,987
MEXICALI,I,115,86,110,15,5,3,219,973
MEXICALI,I,116,140,114,16,10,5,285,894
MEXICALI,I,117,75,79,6,9,1,170,1250
MEXICALI,II,118,63,64,11,4,5,147,579
MEXICALI,II,119,74,86,13,4,7,184,740
MEXICALI,II,121,71,96,8,1,5,181,507
MEXICALI,II,122,134,180,17,15,11,357,955
MEXICALI,II,123,140,178,15,10,9,352,867
MEXICALI,II,124,113,196,18,4,3,334,849
MEXICALI,II,125,107,171,14,12,4,308,745
MEXICALI,II,126,66,119,5,4,1,195,930
MEXICALI,II,127,148,180,12,5,7,352,882
MEXICALI,II,128,91,108,15,5,8,227,850
MEXICALI,II,129,49,60,8,9,2,128,962
MEXICALI,II,130,137,183,22,9,8,359,984
MEXICALI,II,131,120,182,15,11,7,335,783
MEXICALI,II,132,121,171,20,6,6,324,691
MEXICALI,II,133,69,96,8,3,3,179,949
MEXICALI,II,134,119,135,17,6,11,288,878
MEXICALI,II,135,76,93,4,4,2,179,1096
MEXICALI,II,136,119,129,25,3,10,286,1098
MEXICALI,II,137,123,83,8,5,4,223,832
MEXICALI,II,138,100,112,13,7,6,238,774
MEXICALI,II,139,124,75,10,5,3,217,683
MEXICALI,II,140,89,94,10,6,3,202,621
MEXICALI,II,141,110,143,8,10,3,274,774
MEXICALI,II,142,83,119,10,2,2,216,608
MEXICALI,II,143,84,68,8,5,8,173,996
MEXICALI,II,144,106,142,11,5,3,267,820
MEXICALI,II,145,68,80,5,6,5,164,985
MEXICALI,II,146,99,118,15,6,3,241,1340
MEXICALI,II,147,102,142,8,7,5,264,868
MEXICALI,II,148,154,119,4,10,5,292,836
MEXICALI,II,149,135,109,8,4,5,261,863
MEXICALI,II,150,119,115,17,4,11,266,851
MEXICALI,II,151,126,120,10,6,3,265,831
MEXICALI,II,152,161,280,23,12,5,481,1751
MEXICALI,II,153,233,182,24,15,5,459,1280
MEXICALI,II,154,228,288,18,17,8,559,1340
MEXICALI,II,155,151,153,20,9,8,341,1309
MEXICALI,II,156,148,141,10,10,5,314,1060
MEXICALI,II,157,102,128,6,11,6,253,663
MEXICALI,II,158,75,63,5,2,1,146,844
MEXICALI,II,159,155,149,27,7,11,349,1079
MEXICALI,II,161,231,207,36,9,3,486,1115
MEXICALI,II,162,90,118,11,3,4,226,952
MEXICALI,II,163,140,178,16,19,8,361,1153
MEXICALI,II,164,160,127,12,11,5,315,1069
MEXICALI,II,165,85,119,9,1,0,214,874
MEXICALI,II,166,126,167,29,18,9,349,1233
MEXICALI,II,167,68,113,8,7,4,200,865
MEXICALI,II,168,178,150,19,9,9,365,1185
MEXICALI,II,169,131,116,25,8,4,284,843
MEXICALI,II,170,71,77,5,5,3,161,1036
MEXICALI,II,171,172,219,20,11,5,427,1044
MEXICALI,II,172,205,166,27,3,1,402,1122
MEXICALI,II,173,192,236,21,11,7,467,1285
MEXICALI,II,174,181,113,13,4,5,316,782
MEXICALI,II,175,72,83,9,9,4,177,1025
MEXICALI,II,178,129,150,26,7,9,321,1043
MEXICALI,II,179,108,159,16,9,9,301,1200
MEXICALI,II,180,163,157,13,9,3,345,1263
MEXICALI,II,181,212,149,20,10,10,401,1072
MEXICALI,II,182,187,124,14,9,9,343,1044
MEXICALI,II,183,185,149,21,9,3,367,1195
MEXICALI,II,184,263,218,29,29,9,548,2666
MEXICALI,II,185,255,253,31,16,11,566,1436
MEXICALI,II,186,193,214,25,5,3,440,1090
MEXICALI,II,187,244,234,18,24,12,532,2112
MEXICALI,II,188,238,168,23,13,4,446,1774
MEXICALI,II,189,155,188,21,12,11,387,1234
MEXICALI,II,190,46,62,9,2,1,120,783
MEXICALI,II,191,149,108,17,12,1,287,1138
MEXICALI,II,192,160,240,31,10,13,454,1426
MEXICALI,II,194,76,58,1,6,5,146,965
MEXICALI,II,195,152,143,18,18,6,337,1103
MEXICALI,II,196,147,131,20,10,9,317,1119
MEXICALI,II,197,182,124,23,17,6,352,1372
MEXICALI,II,198,111,99,24,18,10,262,1176
MEXICALI,II,199,147,138,13,7,5,310,1181
MEXICALI,III,200,136,155,21,2,10,324,863
MEXICALI,III,202,170,132,16,6,6,330,967
MEXICALI,III,203,128,161,17,9,6,321,838
MEXICALI,IV,204,232,240,30,13,11,526,1453
MEXICALI,IV,205,137,166,20,19,6,348,1073
MEXICALI,IV,206,218,183,22,17,10,450,1337
MEXICALI,IV,207,96,60,11,6,5,178,1282
MEXICALI,IV,208,228,183,22,13,6,452,1436
MEXICALI,IV,209,187,125,29,6,7,354,1044
MEXICALI,IV,210,138,102,15,15,12,282,923
MEXICALI,III,211,209,227,15,12,6,469,1297
MEXICALI,III,212,127,163,13,3,7,313,942
MEXICALI,III,213,129,162,13,6,6,316,797
MEXICALI,III,214,124,140,18,5,5,292,884
MEXICALI,III,215,191,158,22,17,8,396,1330
MEXICALI,III,216,181,168,15,6,12,382,1077
MEXICALI,III,217,167,160,19,6,11,363,1064
MEXICALI,IV,218,159,169,20,6,12,366,1307
MEXICALI,IV,219,214,182,9,19,12,436,1394
MEXICALI,IV,220,69,63,10,1,1,144,948
MEXICALI,III,221,275,275,23,11,5,589,1266
MEXICALI,III,222,196,254,19,10,6,485,1334
MEXICALI,III,223,189,179,16,15,6,405,1071
MEXICALI,III,224,213,212,23,8,14,470,958
MEXICALI,III,225,164,240,31,4,6,445,1086
MEXICALI,III,226,136,197,20,10,6,369,872
MEXICALI,III,227,133,126,12,6,8,285,860
MEXICALI,III,228,182,192,23,8,4,409,1230
MEXICALI,III,230,190,96,19,25,15,345,1506
MEXICALI,III,231,92,99,12,4,11,218,1298
MEXICALI,III,232,149,125,23,8,1,306,906
MEXICALI,III,233,202,279,31,4,5,521,1128
MEXICALI,III,234,140,172,22,3,7,344,802
MEXICALI,III,235,145,233,17,6,10,411,1073
MEXICALI,III,236,191,173,16,7,8,395,1109
MEXICALI,III,237,131,122,12,10,6,281,925
MEXICALI,III,238,118,142,12,11,7,290,929
MEXICALI,III,239,223,111,22,17,11,384,1209
MEXICALI,III,240,73,43,12,5,2,135,860
MEXICALI,III,241,130,90,13,18,8,259,798
MEXICALI,III,242,114,89,11,45,12,271,876
MEXICALI,III,243,158,157,26,12,3,356,824
MEXICALI,III,244,169,245,18,12,4,448,1153
MEXICALI,III,245,208,205,29,17,5,464,1145
MEXICALI,III,246,181,151,12,13,9,366,1078
MEXICALI,III,247,155,150,12,12,11,340,996
MEXICALI,III,248,159,108,25,10,10,312,990
MEXICALI,III,249,145,131,14,17,6,313,959
MEXICALI,III,250,166,163,24,8,8,369,993
MEXICALI,III,251,188,161,18,7,5,379,882
MEXICALI,III,252,168,256,27,11,6,468,1128
MEXICALI,III,253,175,131,16,16,12,350,1054
MEXICALI,III,254,197,219,16,19,15,466,1317
MEXICALI,III,255,87,73,5,10,11,186,1293
MEXICALI,III,256,204,208,24,14,12,462,1462
MEXICALI,III,257,98,125,9,100,0,332,1212
MEXICALI,III,258,249,288,38,18,8,601,1320
MEXICALI,III,259,162,191,16,12,8,389,1148
MEXICALI,III,260,114,87,10,5,5,221,1410
MEXICALI,III,261,243,174,11,23,12,463,1486
MEXICALI,III,262,112,111,8,5,8,244,1491
MEXICALI,III,263,184,159,12,2,10,367,1259
MEXICALI,III,264,153,126,14,6,6,305,1506
MEXICALI,III,265,171,117,6,12,4,310,1556
MEXICALI,III,266,305,176,19,17,16,533,1601
MEXICALI,III,267,269,279,36,13,3,600,1523
MEXICALI,III,268,283,299,37,14,14,647,1389
MEXICALI,III,269,143,147,12,6,7,315,808
MEXICALI,III,270,109,106,10,10,5,240,889
MEXICALI,III,271,72,54,5,10,6,147,888
MEXICALI,III,272,259,162,16,19,9,465,1478
MEXICALI,III,273,225,184,15,14,11,449,1330
MEXICALI,III,274,219,153,26,14,5,417,1379
MEXICALI,III,275,184,165,32,20,9,410,1303
MEXICALI,III,276,118,104,5,6,8,241,745
MEXICALI,III,277,146,134,13,11,6,310,997
MEXICALI,III,278,200,120,26,20,10,376,1399
MEXICALI,III,279,191,163,20,11,10,395,1245
MEXICALI,IV,280,224,163,7,13,14,421,1517
MEXICALI,IV,281,157,100,6,8,6,277,1130
MEXICALI,IV,282,150,78,15,18,10,271,1026
MEXICALI,IV,283,61,63,14,6,4,148,617
MEXICALI,IV,284,95,99,7,4,7,212,879
MEXICALI,IV,285,139,136,13,17,8,313,1234
MEXICALI,IV,286,128,105,22,11,10,276,1583
MEXICALI,IV,287,354,320,47,32,7,760,1804
MEXICALI,IV,288,180,166,16,24,6,392,1040
MEXICALI,IV,289,134,147,9,13,0,303,758
MEXICALI,IV,290,157,146,17,3,6,329,956
MEXICALI,IV,291,698,553,66,37,13,1367,4230
MEXICALI,IV,292,184,276,27,23,6,516,1486
MEXICALI,IV,293,240,167,36,26,4,473,1434
MEXICALI,V,295,80,95,6,9,4,194,589
MEXICALI,IV,296,132,110,16,10,5,273,961
MEXICALI,V,297,171,191,17,10,7,396,1261
MEXICALI,V,298,133,167,16,7,6,329,843
MEXICALI,IV,299,106,101,15,9,3,234,1019
MEXICALI,V,300,112,228,23,16,16,395,1476
MEXICALI,V,301,105,82,13,4,11,215,568
MEXICALI,IV,302,81,133,25,10,7,256,789
MEXICALI,IV,303,124,93,8,22,7,254,834
MEXICALI,IV,304,115,129,20,9,11,284,1142
MEXICALI,IV,305,105,142,24,20,15,306,1195
MEXICALI,V,306,152,267,55,7,14,495,1144
MEXICALI,V,307,81,88,46,3,8,226,717
MEXICALI,V,308,187,209,27,8,7,438,1232
MEXICALI,V,309,223,390,149,10,23,795,2095
MEXICALI,V,310,48,153,44,11,5,261,783
MEXICALI,V,311,161,141,32,7,16,357,1153
MEXICALI,V,312,107,257,44,9,5,422,1337
MEXICALI,V,313,84,183,33,8,4,312,1010
MEXICALI,V,314,70,199,19,9,6,303,1074
MEXICALI,V,315,116,113,26,2,11,268,800
MEXICALI,V,316,89,117,32,5,4,247,761
MEXICALI,V,317,92,116,18,4,11,241,775
MEXICALI,V,318,111,179,37,4,7,338,981
MEXICALI,V,319,72,154,24,3,0,253,657
MEXICALI,V,320,153,127,56,6,20,362,1116
MEXICALI,V,321,96,68,41,3,14,222,868
MEXICALI,VI,322,53,58,8,0,3,122,397
MEXICALI,VI,323,61,55,1,0,8,125,390
MEXICALI,V,324,97,99,34,2,3,235,786
MEXICALI,V,325,117,105,48,3,18,291,853
MEXICALI,V,326,82,111,53,4,7,257,770
MEXICALI,V,327,109,168,45,5,6,333,1024
MEXICALI,V,328,111,112,60,6,12,301,1106
MEXICALI,V,329,84,109,39,13,14,259,781
MEXICALI,V,330,133,105,26,2,11,277,799
MEXICALI,V,331,208,248,85,6,22,569,2147
MEXICALI,V,332,124,84,9,4,20,241,938
MEXICALI,V,333,131,100,15,0,6,252,880
MEXICALI,V,334,103,121,9,11,9,253,1103
MEXICALI,V,335,98,111,14,6,11,240,1050
MEXICALI,V,336,215,193,32,13,28,481,1414
MEXICALI,V,337,32,45,9,1,1,88,372
MEXICALI,V,338,174,141,20,9,12,356,1158
MEXICALI,V,339,171,107,10,6,11,305,981
MEXICALI,V,340,162,134,19,8,5,328,1032
MEXICALI,V,341,156,137,20,8,14,335,916
MEXICALI,V,342,142,87,27,5,15,276,962
MEXICALI,V,343,151,115,22,14,14,316,1179
MEXICALI,V,344,162,165,30,7,12,376,1226
MEXICALI,V,345,103,115,16,0,7,241,1034
MEXICALI,V,346,180,106,37,5,8,336,849
MEXICALI,V,347,70,131,10,15,4,230,729
MEXICALI,V,348,122,116,22,10,10,280,938
MEXICALI,V,349,100,104,41,28,8,281,1069
MEXICALI,V,350,157,202,30,15,17,421,1298
MEXICALI,V,351,57,40,2,5,3,107,347
MEXICALI,V,352,89,130,16,15,9,259,723
MEXICALI,V,353,89,152,16,20,8,285,837
MEXICALI,V,354,100,186,14,18,7,325,862
MEXICALI,V,355,113,158,6,10,9,296,832
MEXICALI,V,356,36,23,9,2,4,74,219
MEXICALI,V,357,74,125,17,6,11,233,788
MEXICALI,V,358,122,212,7,4,6,351,876
MEXICALI,V,359,40,26,14,0,0,80,458
MEXICALI,V,360,63,87,25,4,13,192,1009
MEXICALI,V,361,59,129,88,3,14,293,823
MEXICALI,V,362,152,239,25,27,19,462,1401
MEXICALI,V,363,32,98,10,4,7,151,597
MEXICALI,V,364,90,47,25,9,3,174,874
MEXICALI,V,365,60,70,14,13,2,159,885
MEXICALI,V,366,100,98,24,5,3,230,942
MEXICALI,V,367,98,83,25,10,4,220,909
MEXICALI,V,368,31,69,6,1,8,115,521
MEXICALI,V,369,101,71,41,3,10,226,928
MEXICALI,V,370,100,130,25,6,16,277,903
MEXICALI,V,371,33,40,6,2,4,85,292
MEXICALI,V,372,67,166,10,7,8,258,805
MEXICALI,V,373,82,186,18,2,12,300,923
MEXICALI,V,374,110,158,16,6,4,294,872
MEXICALI,V,375,199,211,55,9,16,490,1431
MEXICALI,V,376,62,137,23,5,11,238,665
MEXICALI,V,377,90,100,15,7,11,223,663
MEXICALI,V,378,63,43,22,7,2,137,477
MEXICALI,V,379,195,189,43,7,8,442,1449
MEXICALI,V,380,99,149,59,2,11,320,1138
MEXICALI,V,381,116,77,62,10,9,274,985
MEXICALI,V,382,88,79,119,7,16,309,1099
MEXICALI,IV,383,170,151,14,12,4,351,1226
MEXICALI,IV,384,89,70,17,6,4,186,689
MEXICALI,IV,385,94,185,18,11,5,313,1085
MEXICALI,IV,386,155,161,24,15,5,360,1329
MEXICALI,IV,387,215,204,29,24,5,477,1284
MEXICALI,IV,388,506,408,46,60,8,1028,3388
MEXICALI,IV,389,577,427,47,49,15,1115,3790
MEXICALI,IV,390,155,160,24,22,7,368,1150
MEXICALI,IV,391,185,203,27,19,6,440,1305
MEXICALI,IV,392,99,121,12,11,4,247,854
MEXICALI,IV,393,96,210,20,16,8,350,1392
MEXICALI,IV,394,71,73,6,7,1,158,667
MEXICALI,IV,395,223,169,12,15,15,434,1448
MEXICALI,IV,396,109,90,11,13,4,227,1451
MEXICALI,IV,397,242,168,16,13,8,447,1559
MEXICALI,IV,398,134,106,16,14,2,272,965
MEXICALI,IV,399,123,126,17,22,10,298,1100
MEXICALI,IV,400,173,181,32,16,5,407,1236
MEXICALI,IV,401,151,145,14,5,10,325,1514
MEXICALI,IV,402,224,171,15,17,14,441,1448
MEXICALI,IV,403,169,93,13,6,7,288,927
MEXICALI,IV,404,227,161,24,16,9,437,1593
MEXICALI,IV,405,193,108,17,18,10,346,1147
MEXICALI,IV,406,143,105,17,4,7,276,875
MEXICALI,IV,407,592,397,44,42,14,1089,3790
MEXICALI,IV,408,144,115,18,14,4,295,829
MEXICALI,VI,409,193,147,22,16,18,396,1225
MEXICALI,VI,410,192,159,21,30,3,405,2220
MEXICALI,VI,411,109,131,5,8,4,257,886
MEXICALI,VI,412,105,110,8,4,11,238,820
MEXICALI,VI,413,102,133,9,7,4,255,1046
MEXICALI,VI,414,124,94,5,10,7,240,859
MEXICALI,VI,415,87,98,13,9,10,217,858
MEXICALI,VI,416,64,43,1,0,0,108,924
MEXICALI,VI,418,87,78,10,6,7,188,863
MEXICALI,VI,419,42,44,6,1,3,96,872
MEXICALI,VI,420,81,97,7,7,3,195,846
MEXICALI,VI,421,157,130,22,15,8,332,1396
MEXICALI,VI,422,1315,1155,136,138,44,2788,13193
MEXICALI,VI,423,79,64,8,6,5,162,1053
MEXICALI,IV,424,117,91,14,6,3,231,724
MEXICALI,IV,425,185,131,20,17,9,362,1152
MEXICALI,IV,426,213,160,20,20,6,419,1380
MEXICALI,IV,427,221,172,12,19,6,430,1397
MEXICALI,IV,428,177,139,10,13,14,353,1095
MEXICALI,IV,429,141,94,12,13,6,266,1056
MEXICALI,IV,430,160,118,19,7,5,309,1298
MEXICALI,IV,431,146,99,13,9,3,270,797
MEXICALI,IV,432,653,462,69,41,26,1251,4516
MEXICALI,IV,433,623,376,61,49,12,1121,3903
MEXICALI,IV,434,86,115,15,12,3,231,651
MEXICALI,IV,435,158,96,13,12,8,287,1141
MEXICALI,IV,436,132,119,12,13,4,280,936
MEXICALI,IV,437,153,90,12,6,6,267,1194
MEXICALI,I,438,43,57,21,4,8,133,1161
MEXICALI,I,439,39,60,18,4,5,126,1100
MEXICALI,I,440,47,53,11,11,7,129,470
MEXICALI,I,441,80,95,18,15,4,212,735
MEXICALI,I,442,34,49,11,5,4,103,923
MEXICALI,I,443,121,96,16,18,3,254,1067
MEXICALI,I,444,88,113,13,10,10,234,1378
MEXICALI,VI,445,97,78,15,7,11,208,901
MEXICALI,VI,446,91,107,8,10,10,226,948
MEXICALI,VI,447,43,55,5,6,5,114,900
MEXICALI,VI,448,42,43,6,1,9,101,761
MEXICALI,VI,449,57,105,7,3,2,174,694
MEXICALI,VI,451,74,108,11,7,12,212,981
MEXICALI,VI,452,93,111,15,14,11,244,1196
MEXICALI,VI,453,133,153,31,9,9,335,1352
MEXICALI,VI,454,56,65,25,3,8,157,1344
MEXICALI,VI,455,117,78,12,7,5,219,852
MEXICALI,VI,456,87,48,11,5,3,154,474
MEXICALI,VI,457,80,123,16,4,7,230,647
MEXICALI,VI,458,155,88,7,0,3,253,649
MEXICALI,VI,459,19,27,1,1,0,48,151
MEXICALI,VI,460,115,175,27,2,10,329,1250
MEXICALI,VI,461,142,135,20,5,3,305,1051
MEXICALI,VI,462,98,67,6,2,7,180,663
MEXICALI,VI,463,79,74,6,2,1,162,493
MEXICALI,VI,464,90,125,7,1,6,229,844
MEXICALI,VI,465,79,125,15,4,7,230,725
MEXICALI,VI,466,37,37,6,1,2,83,298
MEXICALI,VI,467,53,49,15,2,6,125,382
MEXICALI,VI,468,46,53,13,1,3,116,346
MEXICALI,VI,469,61,102,20,3,7,193,560
MEXICALI,VI,470,58,120,22,4,2,206,674
MEXICALI,VI,471,104,230,21,6,14,375,1023
MEXICALI,VI,472,106,98,14,6,6,230,635
MEXICALI,VI,473,36,138,21,2,5,202,641
MEXICALI,VI,474,133,161,17,2,12,325,1045
MEXICALI,VI,475,64,101,9,2,6,182,533
MEXICALI,VI,476,133,190,28,1,14,366,1063
MEXICALI,VI,477,80,156,26,1,5,268,833
MEXICALI,VI,478,63,118,15,3,7,206,711
MEXICALI,VI,479,86,129,16,1,17,249,802
MEXICALI,VI,480,69,113,8,5,4,199,594
MEXICALI,VI,481,53,63,14,5,6,141,548
MEXICALI,VI,482,74,95,12,5,6,192,821
MEXICALI,VI,483,768,525,106,53,25,1477,5545
MEXICALI,VI,484,92,59,15,9,5,180,706
MEXICALI,VI,485,150,130,21,6,12,319,1157
MEXICALI,VI,486,190,212,25,11,14,452,1830
MEXICALI,VI,487,79,75,15,2,11,182,1457
MEXICALI,VI,488,138,175,22,3,11,349,1262
MEXICALI,VI,489,615,637,198,38,35,1523,6809
MEXICALI,VI,490,106,162,27,6,6,307,1087
MEXICALI,VI,491,32,61,7,5,5,110,480
MEXICALI,VI,492,141,165,19,12,16,353,1186
MEXICALI,VI,493,292,307,21,13,28,661,2795
MEXICALI,VI,494,116,121,30,11,13,291,1064
MEXICALI,VI,495,58,70,14,1,5,148,960
MEXICALI,VI,496,97,118,20,6,9,250,911
MEXICALI,VI,497,116,99,20,7,15,257,1232
MEXICALI,VI,498,95,79,8,12,5,199,656
MEXICALI,VI,499,107,109,8,10,8,242,821
MEXICALI,VI,500,71,82,24,3,4,184,510
MEXICALI,VI,501,35,60,7,1,4,107,309
MEXICALI,VI,502,110,161,12,3,6,292,1136
MEXICALI,VI,503,76,81,4,6,3,170,698
MEXICALI,VI,504,100,138,9,2,0,249,900
MEXICALI,VI,505,102,112,12,7,1,234,904
MEXICALI,VI,506,79,151,15,3,4,252,845
MEXICALI,VI,507,144,248,15,2,6,415,1544
MEXICALI,VI,508,55,74,3,2,2,136,960
MEXICALI,VI,509,81,193,18,6,9,307,1060
TIJUANA,VIII,510,201,311,21,5,8,546,1509
TIJUANA,VIII,511,227,400,16,8,9,660,1843
TIJUANA,VIII,512,240,202,18,1,6,467,1034
TIJUANA,VIII,513,239,174,22,4,3,442,946
TIJUANA,VIII,514,224,398,17,9,15,663,1883
TIJUANA,VIII,515,142,277,9,4,7,439,1212
TIJUANA,VIII,516,143,280,11,5,14,453,1131
TIJUANA,VIII,517,291,267,19,6,5,588,1299
TIJUANA,VIII,518,278,206,15,1,7,507,1175
TIJUANA,VIII,519,109,284,17,3,6,419,1090
TIJUANA,VIII,520,158,285,20,5,4,472,1438
TIJUANA,VIII,521,201,274,15,1,12,503,1551
TIJUANA,VIII,522,154,208,10,3,6,381,1076
TIJUANA,VIII,523,238,228,11,5,10,492,1281
TIJUANA,VIII,524,258,170,21,12,10,471,1149
TIJUANA,VIII,525,250,227,13,6,11,507,1299
TIJUANA,VIII,526,224,252,17,4,18,515,1194
TIJUANA,VIII,527,225,252,20,4,3,504,1300
TIJUANA,VIII,528,132,144,4,1,4,285,724
TIJUANA,VIII,529,139,164,6,1,5,315,795
TIJUANA,VIII,530,164,244,17,4,15,444,1327
TIJUANA,VIII,531,352,399,37,11,12,811,1991
TIJUANA,VIII,532,179,279,13,2,8,481,1177
TIJUANA,VIII,533,170,205,11,3,1,390,942
TIJUANA,VIII,534,68,153,16,0,8,245,596
TIJUANA,VIII,535,273,286,13,9,12,593,1450
TIJUANA,VIII,536,236,190,14,4,8,452,1135
TIJUANA,VIII,537,278,265,27,8,16,594,1446
TIJUANA,VIII,538,258,243,11,4,4,520,1273
TIJUANA,VIII,539,173,237,16,2,7,435,1052
TIJUANA,VIII,540,209,190,14,4,7,424,1062
TIJUANA,VIII,541,208,226,16,5,13,468,1169
TIJUANA,VIII,542,108,103,9,3,6,229,664
TIJUANA,VIII,543,259,353,14,4,8,638,1590
TIJUANA,VIII,544,307,303,27,6,9,652,1593
TIJUANA,VIII,545,385,377,23,10,10,805,1814
TIJUANA,VIII,546,341,280,24,3,8,656,1512
TIJUANA,VIII,547,292,299,15,4,8,618,1378
TIJUANA,VIII,548,236,301,17,5,12,571,1425
TIJUANA,VIII,549,96,260,11,0,3,370,1039
TIJUANA,VIII,550,128,198,8,1,6,341,816
TIJUANA,VIII,551,170,223,10,2,6,411,1111
TIJUANA,VIII,552,179,170,7,2,12,370,954
TIJUANA,VIII,553,162,214,19,3,11,409,1065
TIJUANA,VIII,554,134,223,15,4,7,383,930
TIJUANA,VIII,555,184,226,15,3,4,432,1192
TIJUANA,VIII,556,117,163,8,4,1,293,715
TIJUANA,VIII,557,246,309,22,8,15,600,1648
TIJUANA,VIII,558,164,198,25,4,5,396,975
TIJUANA,VIII,559,191,306,25,2,3,527,1455
TIJUANA,VIII,560,176,170,11,5,7,369,927
TIJUANA,VIII,561,122,166,10,2,7,307,745
TIJUANA,IX,562,164,244,9,2,3,422,1102
TIJUANA,IX,563,206,232,19,3,13,473,1135
TIJUANA,VIII,564,195,301,14,3,1,514,1357
TIJUANA,VIII,565,200,360,20,9,18,607,1607
TIJUANA,VIII,566,152,244,8,5,8,417,984
TIJUANA,VIII,567,141,218,13,4,2,378,955
TIJUANA,VIII,568,163,285,16,5,4,473,1157
TIJUANA,VIII,569,194,313,16,2,6,531,1509
TIJUANA,VIII,570,152,249,23,6,3,433,1360
TIJUANA,VIII,571,176,214,20,3,8,421,1120
TIJUANA,VIII,572,161,281,10,6,11,469,1360
TIJUANA,VIII,573,231,505,26,8,9,779,2160
TIJUANA,VIII,574,150,225,12,3,5,395,927
TIJUANA,VIII,575,228,331,21,7,5,592,1508
TIJUANA,VIII,576,182,393,10,5,9,599,1537
TIJUANA,VIII,577,196,545,26,4,20,791,2668
TIJUANA,VIII,578,270,265,19,6,3,563,1480
TIJUANA,VIII,579,456,343,38,2,8,847,2034
TIJUANA,VIII,580,446,343,39,11,9,848,2033
TIJUANA,VIII,581,430,295,38,9,12,784,1860
TIJUANA,VIII,582,358,268,42,3,9,680,1507
TIJUANA,VIII,583,318,201,44,1,8,572,1368
TIJUANA,VIII,584,490,332,47,2,7,878,2086
TIJUANA,VIII,585,276,187,23,7,1,494,1301
TIJUANA,VIII,586,276,174,34,8,3,495,1275
TIJUANA,VIII,587,362,248,35,8,9,662,1643
TIJUANA,VIII,588,413,309,23,6,11,762,1935
TIJUANA,VIII,589,184,189,21,2,8,404,1002
TIJUANA,IX,590,131,176,6,0,2,315,785
TIJUANA,XII,591,99,204,5,2,3,313,1078
TIJUANA,XII,592,81,185,6,1,4,277,929
TIJUANA,XII,593,63,237,14,3,10,327,979
TIJUANA,XII,594,58,121,1,1,1,182,815
TIJUANA,XII,595,80,198,6,2,6,292,952
TIJUANA,XII,596,103,172,8,2,9,294,924
TIJUANA,IX,597,68,141,6,3,3,221,672
TIJUANA,IX,598,128,238,10,3,8,387,1057
TIJUANA,IX,599,132,165,13,1,5,316,914
TIJUANA,XII,600,78,171,2,0,0,251,809
TIJUANA,XII,601,104,110,16,2,3,235,753
TIJUANA,XII,602,68,116,6,1,2,193,676
TIJUANA,IX,603,107,163,9,3,5,287,814
TIJUANA,IX,604,147,200,19,3,4,373,1017
TIJUANA,IX,605,113,147,15,7,6,288,709
TIJUANA,IX,606,121,154,17,1,6,299,990
TIJUANA,IX,607,181,184,8,1,7,381,922
TIJUANA,VIII,608,103,148,13,1,4,269,752
TIJUANA,IX,609,171,219,11,4,5,410,1034
TIJUANA,IX,610,156,182,14,3,7,362,982
TIJUANA,IX,611,152,194,9,2,6,363,925
TIJUANA,IX,612,133,148,4,4,2,291,874
TIJUANA,VIII,613,101,110,11,1,4,227,658
TIJUANA,VIII,614,101,132,7,2,7,249,732
TIJUANA,IX,615,198,177,13,2,5,395,899
TIJUANA,IX,616,107,138,7,2,6,260,715
TIJUANA,IX,617,99,114,8,3,9,233,690
TIJUANA,IX,618,134,112,9,0,2,257,883
TIJUANA,IX,619,172,145,9,0,2,328,861
TIJUANA,IX,620,208,175,10,4,2,399,890
TIJUANA,IX,621,145,164,11,2,4,326,871
TIJUANA,IX,622,157,185,17,5,14,378,1075
TIJUANA,IX,623,184,184,12,11,12,403,1014
TIJUANA,IX,624,241,280,10,2,17,550,1477
TIJUANA,IX,625,170,172,11,3,4,360,872
TIJUANA,IX,626,230,239,16,5,9,499,1296
TIJUANA,IX,627,164,152,8,2,6,332,781
TIJUANA,IX,628,147,159,4,2,7,319,866
TIJUANA,IX,629,216,194,11,5,1,427,1159
TIJUANA,IX,630,182,147,14,1,10,354,889
TIJUANA,IX,631,106,113,14,2,0,235,692
TIJUANA,IX,632,173,182,13,0,6,374,938
TIJUANA,IX,633,144,161,12,2,3,322,843
TIJUANA,IX,634,136,195,7,4,7,349,853
TIJUANA,IX,635,205,145,14,2,3,369,1000
TIJUANA,IX,636,139,174,6,1,8,328,983
TIJUANA,IX,637,225,272,32,2,6,537,1270
TIJUANA,IX,638,139,187,15,3,8,352,985
TIJUANA,IX,639,251,218,13,4,10,496,1158
TIJUANA,IX,640,237,276,16,11,9,549,1273
TIJUANA,IX,641,195,278,16,4,8,501,1392
TIJUANA,IX,642,222,241,10,5,9,487,1227
TIJUANA,IX,643,163,160,3,6,8,340,798
TIJUANA,IX,644,223,179,8,4,7,421,1133
TIJUANA,IX,645,194,217,17,6,8,442,1243
TIJUANA,IX,646,193,218,13,4,13,441,1126
TIJUANA,IX,647,106,109,4,1,7,227,587
TIJUANA,IX,648,156,173,10,3,6,348,873
TIJUANA,IX,649,104,79,3,0,2,188,412
TIJUANA,IX,650,169,173,6,1,7,356,928
TIJUANA,IX,651,183,175,6,5,7,376,1065
TIJUANA,IX,652,136,147,7,2,5,297,861
TIJUANA,IX,653,220,298,17,4,7,546,1442
TIJUANA,IX,654,246,339,18,3,5,611,1334
TIJUANA,IX,655,172,233,7,4,3,419,969
TIJUANA,IX,656,139,230,6,2,12,389,901
TIJUANA,IX,657,113,205,11,4,7,340,984
TIJUANA,IX,658,161,425,16,5,15,622,1561
TIJUANA,IX,659,271,320,24,9,14,638,1951
TIJUANA,IX,660,201,302,15,4,11,533,1220
TIJUANA,IX,661,190,416,21,4,11,642,1654
TIJUANA,IX,662,159,220,23,0,10,412,1101
TIJUANA,IX,663,205,403,10,5,10,633,1589
TIJUANA,IX,664,158,297,21,6,5,487,1250
TIJUANA,XII,665,120,176,16,4,10,326,1048
TIJUANA,XII,666,99,138,14,0,4,255,775
TIJUANA,XII,667,151,181,10,1,6,349,1084
TIJUANA,XII,668,117,134,8,3,3,265,884
TIJUANA,XII,669,153,142,8,1,6,310,888
TIJUANA,XII,670,94,103,2,1,3,203,497
TIJUANA,XII,671,119,97,15,2,7,240,720
TIJUANA,XII,672,77,76,1,0,5,159,457
TIJUANA,XII,673,167,189,11,1,2,370,969
TIJUANA,XII,674,126,128,8,2,4,268,753
TIJUANA,XII,675,182,169,11,1,2,365,1016
TIJUANA,X,676,167,106,10,0,3,286,640
TIJUANA,X,677,189,193,20,4,2,408,902
TIJUANA,X,678,174,192,12,4,0,382,812
TIJUANA,X,679,143,168,14,3,2,330,700
TIJUANA,X,680,148,156,11,0,4,319,725
TIJUANA,IX,681,123,91,8,2,3,227,538
TIJUANA,IX,682,141,170,8,1,5,325,889
TIJUANA,IX,683,220,217,17,5,5,464,1146
TIJUANA,IX,684,251,219,23,4,8,505,1066
TIJUANA,IX,685,277,319,13,6,18,633,1774
TIJUANA,IX,686,133,194,11,2,7,347,1100
TIJUANA,X,687,110,109,14,1,2,236,535
TIJUANA,X,688,239,136,17,10,7,409,767
TIJUANA,IX,689,162,190,12,4,9,377,841
TIJUANA,IX,690,126,152,6,1,4,289,819
TIJUANA,IX,691,87,131,9,2,3,232,613
TIJUANA,IX,692,103,165,6,3,3,280,673
TIJUANA,IX,693,139,144,7,2,4,296,802
TIJUANA,IX,694,106,153,5,0,13,277,841
TIJUANA,IX,695,82,128,7,1,3,221,549
TIJUANA,IX,696,149,138,21,3,3,314,740
TIJUANA,IX,697,183,217,7,3,6,416,1027
TIJUANA,IX,698,86,116,3,1,4,210,525
TIJUANA,IX,699,129,169,9,4,5,316,737
TIJUANA,IX,700,56,108,1,3,2,170,423
TIJUANA,IX,701,166,214,9,8,4,401,947
TIJUANA,IX,702,118,242,5,7,6,378,925
TIJUANA,IX,703,206,200,9,4,9,428,982
TIJUANA,IX,704,180,162,15,1,2,360,823
TIJUANA,X,705,273,245,31,4,8,561,1162
TIJUANA,X,706,102,162,8,3,2,277,769
TIJUANA,X,707,71,85,6,0,1,163,442
TIJUANA,IX,708,198,166,6,2,6,378,956
TIJUANA,IX,709,156,231,6,2,8,403,964
TIJUANA,IX,710,103,111,7,4,3,228,621
TIJUANA,IX,711,327,346,15,3,7,698,1657
TIJUANA,IX,712,225,238,17,1,5,486,1281
TIJUANA,X,713,121,233,11,2,4,371,947
TIJUANA,X,714,211,382,20,6,9,628,1653
TIJUANA,IX,715,242,244,13,6,2,507,1271
TIJUANA,IX,716,236,210,12,5,9,472,1204
TIJUANA,IX,717,246,290,7,3,9,555,1418
TIJUANA,IX,718,184,193,15,4,7,403,1028
TIJUANA,IX,719,292,215,20,6,10,543,1344
TIJUANA,IX,720,174,122,7,0,5,308,681
TIJUANA,X,721,88,121,7,1,7,224,623
TIJUANA,IX,722,334,351,23,7,6,721,1651
TIJUANA,IX,723,258,335,18,7,10,628,1521
TIJUANA,IX,724,174,216,11,1,3,405,920
TIJUANA,XII,725,179,183,10,1,4,377,835
TIJUANA,X,726,606,507,44,12,13,1182,2247
TIJUANA,X,727,128,217,6,2,4,357,943
TIJUANA,X,728,300,252,8,2,2,564,1206
TIJUANA,X,729,241,267,14,6,8,536,1419
TIJUANA,X,730,348,224,25,2,7,606,1277
TIJUANA,X,731,133,194,10,4,9,350,962
TIJUANA,X,732,49,108,6,0,0,163,394
TIJUANA,X,733,203,355,23,7,11,599,1547
TIJUANA,X,734,264,170,17,3,8,462,1026
TIJUANA,X,735,183,239,15,9,7,453,1106
TIJUANA,X,736,123,248,13,6,11,401,1148
TIJUANA,X,737,263,466,33,7,27,796,2035
TIJUANA,X,738,134,210,13,6,3,366,1016
TIJUANA,X,739,12,78,3,1,3,97,750
TIJUANA,X,740,134,159,6,3,7,309,817
TIJUANA,X,741,437,465,29,21,11,963,2333
TIJUANA,X,742,157,159,12,1,5,334,653
TIJUANA,X,743,368,299,28,2,9,706,1269
TIJUANA,X,744,418,294,19,7,4,742,1582
TIJUANA,X,745,295,246,22,3,7,573,1127
TIJUANA,X,746,204,122,9,4,6,345,651
TIJUANA,X,747,353,226,16,1,3,599,1229
TIJUANA,X,748,316,229,14,2,3,564,1109
TIJUANA,X,749,314,208,23,4,3,552,977
TIJUANA,X,750,360,243,22,3,4,632,1200
TIJUANA,X,751,273,150,25,4,12,464,979
TIJUANA,X,752,212,175,18,4,3,412,958
TIJUANA,X,753,143,123,9,3,2,280,781
TIJUANA,X,754,285,162,11,6,3,467,1136
TIJUANA,X,755,369,257,23,4,5,658,1554
TIJUANA,X,756,269,158,12,3,4,446,884
TIJUANA,X,757,194,110,7,3,3,317,731
TIJUANA,X,758,247,207,19,2,6,481,940
TIJUANA,X,759,314,283,19,1,5,622,1193
TIJUANA,X,760,306,216,19,6,6,553,1074
TIJUANA,X,761,153,171,11,7,6,348,894
TIJUANA,X,762,206,203,17,2,5,433,1015
TIJUANA,X,763,315,307,21,4,5,652,1558
TIJUANA,X,764,346,330,18,4,4,702,1647
TIJUANA,X,765,286,224,29,2,4,545,1167
TIJUANA,X,766,320,263,15,5,8,611,1351
TIJUANA,XI,767,148,132,12,1,10,303,735
TIJUANA,XI,768,131,124,15,1,3,274,632
TIJUANA,XI,769,277,246,11,6,12,552,1473
TIJUANA,XI,770,186,122,10,1,1,320,835
TIJUANA,XI,771,274,239,22,0,8,543,1483
TIJUANA,XII,772,972,642,75,9,17,1715,4156
TIJUANA,XIII,773,288,279,20,5,13,605,1809
TIJUANA,XIII,774,359,233,16,5,10,623,1760
TIJUANA,XIII,775,675,538,56,10,21,1300,4548
TIJUANA,XIII,776,386,255,31,7,5,684,2363
TIJUANA,XIII,777,313,253,23,10,9,608,1837
TIJUANA,XIII,778,393,271,21,3,25,713,2277
TIJUANA,XIII,779,318,239,26,2,9,594,2512
TIJUANA,XIII,780,437,236,23,7,8,711,2139
TIJUANA,XIII,781,422,237,25,6,4,694,2141
TIJUANA,XII,782,694,587,48,12,19,1360,3085
TIJUANA,XII,783,553,471,45,15,9,1093,2516
TIJUANA,XIII,784,627,358,41,5,8,1039,2839
TIJUANA,XI,785,270,163,12,5,5,455,1202
TIJUANA,XI,786,602,449,26,9,18,1104,3622
TIJUANA,XI,787,472,531,44,4,25,1076,3471
TIJUANA,XI,788,429,431,22,4,11,897,2690
TIJUANA,XI,789,219,199,16,2,12,448,1703
TIJUANA,XI,790,469,476,31,5,12,993,2893
TIJUANA,XI,791,253,250,15,3,9,530,1394
TIJUANA,XI,792,251,207,12,2,3,475,1308
TIJUANA,XI,793,451,457,35,9,14,966,2713
TIJUANA,XI,794,265,190,17,1,8,481,1421
TIJUANA,XI,795,321,190,26,6,9,552,1397
TIJUANA,X,796,507,431,36,5,12,991,2243
TIJUANA,X,797,284,167,17,6,2,476,987
TIJUANA,X,798,230,177,9,1,1,418,1023
TIJUANA,X,799,138,118,5,2,1,264,743
TIJUANA,X,800,151,118,11,2,5,287,726
TIJUANA,X,801,224,166,7,3,6,406,1065
TIJUANA,X,802,361,219,19,9,7,615,1543
TIJUANA,X,803,169,181,10,4,3,367,879
TIJUANA,X,804,107,84,8,0,4,203,448
TIJUANA,X,805,325,474,25,3,5,832,2469
TIJUANA,X,806,375,241,18,4,10,648,1599
TIJUANA,X,807,554,482,34,8,8,1086,2996
TIJUANA,X,808,206,163,13,2,4,388,969
TIJUANA,X,809,197,165,7,2,3,374,878
TIJUANA,X,810,269,193,18,1,2,483,1357
TIJUANA,X,811,235,158,12,4,3,412,1067
TIJUANA,X,812,234,141,19,5,2,401,1089
TIJUANA,X,813,245,215,19,5,7,491,1301
TIJUANA,X,814,148,104,13,0,2,267,656
TIJUANA,X,815,193,125,4,1,4,327,636
TIJUANA,X,816,169,111,5,5,2,292,923
TIJUANA,X,817,96,95,9,2,31,233,630
TIJUANA,X,818,507,320,23,7,15,872,2141
TIJUANA,XI,819,296,264,17,4,5,586,1632
TIJUANA,XI,820,235,224,23,6,14,502,1405
TIJUANA,XII,821,83,102,4,1,3,193,610
TIJUANA,XII,822,112,96,11,3,1,223,627
TIJUANA,XII,823,221,178,17,4,3,423,940
TIJUANA,XII,824,227,183,21,5,6,442,1051
TIJUANA,XII,825,173,161,14,4,3,355,1028
TIJUANA,XII,826,253,247,16,3,9,528,1435
TIJUANA,XII,827,223,182,10,1,13,429,1240
TIJUANA,XII,828,177,194,8,1,8,388,967
TIJUANA,XII,829,193,215,18,6,10,442,1245
TIJUANA,XII,830,224,211,10,4,10,459,1219
TIJUANA,XII,831,287,223,22,4,12,548,1514
TIJUANA,XII,832,184,215,19,1,5,424,1053
TIJUANA,XII,833,191,180,18,3,3,395,1142
TIJUANA,XII,834,132,155,9,3,2,301,916
TIJUANA,XII,835,151,130,9,2,12,304,895
TIJUANA,XII,836,280,211,22,4,13,530,1348
TIJUANA,XII,837,386,306,19,8,17,736,1909
TIJUANA,XII,838,317,248,19,6,6,596,1463
TIJUANA,XII,839,191,191,13,3,4,402,1103
TIJUANA,XII,840,220,223,16,7,4,470,1283
TIJUANA,XII,841,188,165,8,3,5,369,895
TIJUANA,XII,842,159,134,7,1,0,301,719
TIJUANA,XII,843,100,187,9,5,3,304,847
TIJUANA,XII,844,303,349,24,3,15,694,2069
TIJUANA,XII,845,135,172,7,0,5,319,898
TIJUANA,XII,846,176,258,6,1,16,457,1346
TIJUANA,XII,847,147,191,3,3,3,347,990
TIJUANA,XII,848,202,214,16,2,3,437,1110
TIJUANA,XII,849,269,219,25,4,7,524,1106
TIJUANA,XII,850,186,139,9,2,6,342,882
TIJUANA,XII,851,214,201,16,5,6,442,1069
TIJUANA,XII,852,660,573,53,12,14,1312,3127
TIJUANA,XII,853,130,274,12,2,9,427,1115
TIJUANA,XII,854,311,515,25,9,11,871,2456
TIJUANA,XII,855,240,435,24,14,7,720,1911
TIJUANA,XII,856,167,207,17,5,10,406,1116
TIJUANA,XII,857,387,636,36,12,18,1089,2827
TIJUANA,XII,858,314,599,39,8,23,983,2878
TIJUANA,XII,859,391,325,26,5,5,752,1712
TIJUANA,XII,860,402,274,24,7,10,717,1897
TIJUANA,XII,861,241,159,14,3,3,420,1274
TIJUANA,XII,862,166,171,11,1,9,358,1139
TIJUANA,XII,863,568,524,33,8,8,1141,2834
TIJUANA,XII,864,365,268,22,4,3,662,1425
TIJUANA,XII,865,324,286,17,8,7,642,1370
TIJUANA,XII,866,110,114,23,5,4,256,690
TIJUANA,XII,867,213,249,18,1,11,492,1255
TIJUANA,XII,868,196,214,10,3,4,427,1249
TIJUANA,XII,869,292,283,16,9,7,607,1887
TIJUANA,XII,870,223,146,11,3,5,388,1166
TIJUANA,XII,871,246,194,7,1,6,454,1158
TIJUANA,XII,872,223,277,14,5,7,526,1467
TIJUANA,XII,873,152,138,7,0,2,299,858
TIJUANA,XII,874,241,232,13,8,4,498,1287
TIJUANA,XII,875,240,182,11,3,4,440,1173
TIJUANA,XII,876,166,205,5,5,5,386,974
TIJUANA,XII,877,165,155,11,14,10,355,964
TIJUANA,XII,878,171,156,7,4,2,340,1044
TIJUANA,XI,879,167,170,14,4,10,365,988
TIJUANA,XI,880,244,219,22,4,10,499,1410
TIJUANA,VIII,881,155,232,9,0,5,401,1056
TIJUANA,VIII,882,119,239,11,2,8,379,881
ROSARITO,XVI,883,128,160,18,5,10,321,825
ROSARITO,XVI,884,253,445,22,21,20,761,2002
ROSARITO,XVI,885,156,272,32,40,20,520,1397
ROSARITO,XVI,886,293,338,26,63,20,740,2201
ROSARITO,XVI,887,156,257,30,27,8,478,1222
ROSARITO,XVI,888,211,235,15,4,11,476,1283
ROSARITO,XVI,889,220,342,62,7,10,641,1759
ROSARITO,XVI,890,47,88,5,3,0,143,516
ROSARITO,XVI,890,868,531,442,68,60,1969,6392
TIJUANA,VIII,891,1097,1364,96,40,25,2622,6391
ROSARITO,XVI,892,236,122,124,14,19,515,1587
ROSARITO,XVI,893,332,165,281,18,11,807,2423
ROSARITO,XVI,894,337,177,246,11,13,784,2050
ROSARITO,XVI,895,511,292,328,39,24,1194,3179
ROSARITO,XVI,896,133,60,70,11,4,278,769
ROSARITO,XVI,897,160,71,86,2,5,324,845
ROSARITO,XVI,898,217,167,108,6,16,514,1458
ROSARITO,XVI,899,210,96,108,10,4,428,1275
ROSARITO,XVI,900,154,80,138,6,13,391,1046
ROSARITO,XVI,901,303,121,187,9,12,632,1617
ROSARITO,XVI,902,1,3,1,0,0,5,23
ROSARITO,XVI,902,149,140,145,8,11,453,1058
ROSARITO,XVI,903,340,281,194,28,26,869,2506
ROSARITO,XVI,904,306,225,134,21,12,698,1990
ROSARITO,XVI,905,432,272,206,21,20,951,2817
ROSARITO,XVI,906,510,270,424,15,19,1238,3456
ROSARITO,XVI,907,660,389,576,37,30,1692,4905
ROSARITO,XVI,908,189,145,96,13,9,452,1357
ROSARITO,XVI,909,363,140,213,12,9,737,2065
ROSARITO,XVI,910,526,374,353,29,16,1298,3788
TIJUANA,X,911,115,234,4,1,7,361,989
TIJUANA,X,912,209,226,9,4,17,465,1371
TIJUANA,X,913,180,300,17,3,9,509,1473
TIJUANA,X,914,301,379,14,1,9,704,2118
ROSARITO,XVI,915,405,568,30,11,14,1028,3103
ROSARITO,XVI,916,276,345,22,6,16,665,1860
TIJUANA,X,917,534,601,29,9,18,1191,3597
TIJUANA,X,918,611,883,56,12,31,1593,4384
ROSARITO,XVI,919,382,520,45,12,17,976,3110
ROSARITO,XVI,920,212,292,9,8,17,538,1729
ROSARITO,XVI,921,196,194,19,17,15,441,1261
ROSARITO,XVI,922,581,686,39,24,34,1364,4358
ROSARITO,XVI,923,454,410,17,13,18,912,2819
ROSARITO,XVI,924,408,440,24,22,23,917,2622
ROSARITO,XVI,925,205,208,21,20,16,470,1287
ROSARITO,XVI,926,261,356,35,13,14,679,1742
ROSARITO,XVI,927,296,477,34,11,19,837,2261
ROSARITO,XVI,928,215,261,12,7,9,504,1258
ROSARITO,XVI,929,557,916,59,25,24,1581,4609
ROSARITO,XVI,930,139,179,24,9,10,361,936
ROSARITO,XVI,931,407,482,27,31,20,967,3074
ROSARITO,XVI,932,301,351,32,17,10,711,1833
ROSARITO,XVI,933,507,542,46,9,14,1118,3011
ROSARITO,XVI,934,425,445,25,3,17,915,2188
ROSARITO,XVI,935,242,344,14,4,10,614,1745
ROSARITO,XVI,936,226,307,20,12,12,577,1834
ROSARITO,XVI,937,282,266,19,5,4,576,1544
ROSARITO,XVI,938,344,398,32,23,19,816,2165
ROSARITO,XVI,939,293,417,28,12,25,775,2543
ROSARITO,XVI,940,301,462,28,9,20,820,2558
TIJUANA,X,941,1131,1091,55,19,35,2331,7177
TIJUANA,XIII,942,962,1374,74,35,48,2493,7210
ROSARITO,XVI,943,284,382,36,10,25,737,2455
TIJUANA,XIII,944,267,301,17,6,14,605,1577
TIJUANA,XIII,945,187,169,11,3,7,377,972
TIJUANA,XIII,946,358,214,22,8,4,606,1378
TIJUANA,XIII,947,198,129,10,4,2,343,770
TIJUANA,XIII,948,827,983,47,13,35,1905,5328
TIJUANA,XI,949,126,87,7,1,2,223,592
TIJUANA,XI,950,297,223,30,7,1,558,1483
TIJUANA,XI,951,684,370,38,7,14,1113,2825
TIJUANA,XI,952,312,226,16,2,5,561,1312
TIJUANA,XI,953,314,211,23,6,9,563,1442
TIJUANA,XI,954,160,127,12,1,2,302,753
TIJUANA,XI,955,288,304,26,7,15,640,1823
TIJUANA,XI,956,305,288,31,3,15,642,2110
TIJUANA,XIII,957,364,294,31,4,9,702,2016
TIJUANA,XI,958,213,158,16,2,4,393,1192
TIJUANA,XI,959,184,151,16,4,4,359,1152
TIJUANA,XI,960,247,228,15,3,12,505,1669
TIJUANA,XI,961,209,202,15,1,7,434,1378
TIJUANA,XI,962,124,142,9,4,12,291,1224
TIJUANA,XIII,963,264,246,17,6,8,541,1562
TIJUANA,XIII,964,231,261,21,6,12,531,1646
TIJUANA,XIII,965,237,252,9,6,7,511,1380
TIJUANA,XIII,966,1936,2048,127,40,76,4227,14216
TIJUANA,XIII,967,263,243,16,3,3,528,1510
TIJUANA,XIII,968,141,144,7,2,6,300,946
TIJUANA,XIII,969,339,391,22,9,10,771,2172
TIJUANA,XIII,970,155,206,22,5,8,396,1023
TIJUANA,XIII,971,189,274,18,3,5,489,1422
TIJUANA,XIII,972,161,243,15,4,12,435,1384
TIJUANA,XI,973,357,293,13,6,21,690,2419
TIJUANA,XI,974,361,272,25,4,6,668,2025
TIJUANA,XIII,975,324,321,30,7,9,691,2653
TIJUANA,XIII,976,174,205,24,4,3,410,1625
TIJUANA,XIII,977,168,158,26,5,9,366,1370
TIJUANA,XIII,978,227,235,26,0,5,493,1809
TIJUANA,XIII,979,257,390,24,5,7,683,2283
TIJUANA,XIII,980,205,317,28,6,14,570,1923
TIJUANA,XIII,981,100,128,15,3,6,252,862
TIJUANA,XIII,982,175,141,10,2,1,329,1078
TIJUANA,XIII,983,221,149,22,9,11,412,1461
TIJUANA,XIII,984,165,152,12,2,4,335,1072
TIJUANA,XIII,985,115,181,12,2,6,316,1182
TIJUANA,XIII,986,174,259,17,4,5,459,1475
TIJUANA,XIII,987,211,216,11,8,6,452,1662
TIJUANA,XIII,988,227,202,13,4,10,456,1607
TIJUANA,XIII,989,148,161,9,2,9,329,1398
TIJUANA,XIII,990,396,392,32,5,13,838,2560
TIJUANA,XI,991,303,231,12,3,4,553,1464
TIJUANA,XI,992,311,262,21,6,6,606,1423
TIJUANA,XI,993,302,201,21,5,10,539,1322
TIJUANA,XI,994,917,616,55,15,33,1636,4247
TIJUANA,XI,995,399,322,17,9,16,763,1929
TIJUANA,XI,996,396,281,22,7,4,710,1744
TIJUANA,XI,997,405,288,20,6,8,727,1816
TIJUANA,XI,998,129,96,2,1,5,233,653
TIJUANA,XI,999,440,343,17,8,4,812,2296
TIJUANA,XI,1000,438,356,24,8,10,836,2077
TIJUANA,XI,1001,275,197,11,1,6,490,1236
TIJUANA,XI,1002,187,219,9,1,5,421,1140
TIJUANA,XI,1003,333,318,31,8,22,712,1808
TIJUANA,XI,1004,227,190,18,3,12,450,1559
TIJUANA,XI,1005,574,414,26,6,7,1027,3399
TIJUANA,XI,1006,998,859,62,14,32,1965,5481
TIJUANA,XI,1007,1247,954,66,24,27,2318,7118
TIJUANA,XI,1008,735,620,49,10,13,1427,4468
TIJUANA,XI,1009,578,406,54,10,14,1062,2765
TIJUANA,XI,1010,542,364,23,8,13,950,2283
TIJUANA,XIII,1011,672,589,45,8,18,1332,4619
TIJUANA,XIII,1012,437,407,28,4,13,889,3244
TIJUANA,XI,1013,248,163,15,6,8,440,1244
TIJUANA,XI,1014,218,203,25,4,7,457,1337
TIJUANA,XI,1015,314,253,22,7,6,602,2020
TIJUANA,XI,1016,182,152,14,4,5,357,1153
TIJUANA,XI,1017,180,151,7,3,3,344,1074
TIJUANA,XI,1018,445,493,36,9,19,1002,3048
TIJUANA,XI,1019,760,483,51,11,13,1318,3899
TIJUANA,XI,1020,433,323,42,13,4,815,2482
TIJUANA,XIII,1021,960,1004,60,20,17,2061,7405
TIJUANA,XIII,1022,527,766,46,6,22,1367,4718
TIJUANA,XIII,1023,220,286,22,5,9,542,1819
TIJUANA,XIII,1024,280,246,10,5,7,548,1758
TIJUANA,XIII,1025,240,224,32,4,8,508,1799
TIJUANA,XIII,1026,857,1232,59,15,36,2199,8017
TIJUANA,XIII,1027,831,1156,87,11,45,2130,6436
TIJUANA,XIII,1028,1370,819,81,16,13,2299,6625
TIJUANA,XIII,1029,1332,1063,86,28,21,2530,7949
TIJUANA,XIII,1030,981,835,84,19,23,1942,7028
TIJUANA,XIII,1031,1377,1822,195,40,67,3501,12382
TIJUANA,XIII,1032,148,152,18,5,7,330,919
ROSARITO   ,XVI,1033,120,48,80,8,2,258,792
ROSARITO,XVI,1034,131,166,17,1,4,319,775
ROSARITO,XVI,1035,121,146,14,3,7,291,706
ROSARITO,XVI,1036,160,210,14,3,7,394,1070
ROSARITO,XVI,1037,170,150,28,5,9,362,1011
ROSARITO,XVI,1038,394,609,31,26,20,1080,3050
TIJUANA,X,1039,85,241,12,20,12,370,849
TIJUANA,X,1040,21,52,6,2,1,82,213
TIJUANA,X,1041,53,96,8,3,2,162,444
ENSENADA,XIV,1042,139,95,69,8,5,316,773
ENSENADA,XIV,1043,292,104,133,14,6,549,1114
ENSENADA,XIV,1044,90,172,109,2,17,390,1163
ENSENADA,XIV,1045,245,378,140,15,23,801,2264
ENSENADA,XIV,1046,83,74,27,7,3,194,523
ENSENADA,XIV,1047,77,129,59,4,9,278,787
ENSENADA,XIV,1048,75,69,52,3,9,208,682
ENSENADA,XIV,1049,120,128,52,8,6,314,841
ENSENADA,XIV,1050,159,127,62,9,7,364,1064
ENSENADA,XIV,1051,297,229,100,10,15,651,1827
ENSENADA,XIV,1052,249,227,117,16,21,630,1792
ENSENADA,XIV,1053,197,191,48,9,8,453,1388
ENSENADA,XIV,1054,251,277,142,25,24,719,2309
ENSENADA,XIV,1055,473,622,326,24,32,1477,5611
ENSENADA,XIV,1056,180,236,103,26,11,556,1701
ENSENADA,XIV,1057,205,233,88,17,12,555,1679
ENSENADA,XIV,1058,214,320,94,11,13,652,2052
ENSENADA,XIV,1059,586,409,192,20,11,1218,2987
ENSENADA,XIV,1060,263,159,87,13,8,530,1370
ENSENADA,XIV,1061,252,147,119,6,13,537,1306
ENSENADA,XIV,1062,167,94,35,8,10,314,777
ENSENADA,XIV,1063,230,131,115,8,16,500,1047
ENSENADA,XIV,1064,299,207,110,16,9,641,1370
ENSENADA,XIV,1065,225,188,83,10,9,515,1378
ENSENADA,XIV,1066,240,156,66,11,8,481,1109
ENSENADA,XIV,1067,180,85,80,7,2,354,808
ENSENADA,XIV,1068,226,195,54,19,12,506,1237
ENSENADA,XIV,1069,62,62,36,6,1,167,552
ENSENADA,XIV,1070,182,93,61,9,4,349,875
ENSENADA,XIV,1071,151,158,52,13,7,381,1084
ENSENADA,XIV,1072,83,99,40,3,2,227,690
ENSENADA,XIV,1073,161,261,78,4,19,523,1634
ENSENADA,XIV,1074,160,210,54,11,14,449,1513
ENSENADA,XIV,1075,154,174,53,4,9,394,1082
ENSENADA,XIV,1076,66,155,48,11,2,282,871
ENSENADA,XIV,1077,67,130,81,2,11,291,1022
ENSENADA,XIV,1078,61,138,128,7,8,342,1049
ENSENADA,XIV,1079,126,212,95,8,14,455,1455
ENSENADA,XIV,1080,162,172,73,7,15,429,1411
ENSENADA,XIV,1081,155,181,114,9,8,467,1426
ENSENADA,XIV,1082,198,109,57,13,10,387,1098
ENSENADA,XIV,1083,166,107,83,4,5,365,947
ENSENADA,XIV,1084,224,175,72,3,14,488,1080
ENSENADA,XIV,1085,132,99,43,10,5,289,682
ENSENADA,XIV,1086,125,106,29,3,15,278,813
ENSENADA,XIV,1087,202,117,70,15,3,407,901
ENSENADA,XIV,1088,208,150,105,11,9,483,1232
ENSENADA,XIV,1089,250,255,116,11,9,641,1546
ENSENADA,XIV,1090,51,38,18,0,2,109,410
ENSENADA,XIV,1091,59,53,23,3,5,143,624
ENSENADA,XIV,1092,68,117,20,0,3,208,636
ENSENADA,XIV,1093,158,102,34,8,8,310,929
ENSENADA,XIV,1094,91,90,33,13,7,234,660
ENSENADA,XIV,1095,245,94,52,3,4,398,1003
ENSENADA,XIV,1096,143,64,39,2,1,249,667
ENSENADA,XIV,1097,104,146,78,5,8,341,1015
ENSENADA,XIV,1098,49,116,57,6,13,241,772
ENSENADA,XIV,1099,211,186,69,6,8,480,1431
ENSENADA,XIV,1100,160,144,59,4,8,375,1165
ENSENADA,XIV,1101,234,248,96,18,11,607,1821
ENSENADA,XIV,1102,146,173,95,9,18,441,1404
ENSENADA,XIV,1103,70,131,102,7,14,324,1125
ENSENADA,XIV,1104,173,105,53,6,10,347,913
ENSENADA,XIV,1105,129,109,46,7,8,299,811
ENSENADA,XIV,1106,269,136,55,12,11,483,1245
ENSENADA,XIV,1107,206,127,37,10,3,383,994
ENSENADA,XIV,1108,182,80,48,6,8,324,915
ENSENADA,XV,1109,171,106,62,8,9,356,941
ENSENADA,XIV,1110,139,132,41,4,3,319,860
ENSENADA,XIV,1111,147,91,36,5,7,286,823
ENSENADA,XIV,1112,168,140,56,15,4,383,859
ENSENADA,XIV,1113,237,165,69,14,9,494,1266
ENSENADA,XIV,1114,135,106,66,8,11,326,796
ENSENADA,XIV,1115,211,125,63,2,9,410,1108
ENSENADA,XIV,1116,170,134,93,22,12,431,1134
ENSENADA,XV,1117,240,157,63,6,7,473,1186
ENSENADA,XV,1118,297,131,98,9,8,543,1170
ENSENADA,XV,1119,202,139,74,13,7,435,1016
ENSENADA,XV,1120,243,139,64,10,8,464,1183
ENSENADA,XV,1121,141,116,48,9,7,321,851
ENSENADA,XIV,1122,132,89,48,6,1,276,715
ENSENADA,XIV,1123,78,80,43,5,5,211,554
ENSENADA,XV,1124,216,145,45,5,4,415,1082
ENSENADA,XV,1125,214,142,68,7,11,442,1017
ENSENADA,XV,1126,235,136,62,5,9,447,941
ENSENADA,XV,1127,308,180,83,31,12,614,1405
ENSENADA,XV,1128,226,189,105,16,13,549,1501
ENSENADA,XV,1129,219,174,105,7,12,517,1740
ENSENADA,XV,1130,238,135,70,4,10,457,1013
ENSENADA,XV,1131,324,145,84,16,3,572,1248
ENSENADA,XV,1132,172,86,61,6,10,335,729
ENSENADA,XV,1133,222,134,72,9,4,441,1077
ENSENADA,XV,1134,193,118,56,11,4,382,966
ENSENADA,XV,1135,198,144,57,10,12,421,1135
ENSENADA,XIV,1136,177,151,65,8,6,407,1236
ENSENADA,XIV,1137,86,136,80,8,10,320,1120
ENSENADA,XIV,1138,72,104,60,4,4,244,791
ENSENADA,XIV,1139,222,209,87,19,18,555,1741
ENSENADA,XV,1140,132,126,38,11,5,312,1094
ENSENADA,XV,1141,247,225,126,20,12,630,1631
ENSENADA,XV,1142,218,155,69,14,9,465,1281
ENSENADA,XV,1143,283,240,101,8,11,643,1469
ENSENADA,XV,1144,225,170,88,18,11,512,1291
ENSENADA,XV,1145,254,177,89,17,22,559,1480
ENSENADA,XV,1146,314,207,133,19,11,684,1702
ENSENADA,XV,1147,272,222,125,20,15,654,1589
ENSENADA,XV,1148,208,172,80,15,9,484,1488
ENSENADA,XIV,1149,288,238,141,30,11,708,2042
ENSENADA,XIV,1150,121,241,119,13,13,507,1828
ENSENADA,XV,1151,261,143,91,12,3,510,1294
ENSENADA,XV,1152,138,56,55,8,3,260,681
ENSENADA,XV,1153,178,142,57,8,4,389,868
ENSENADA,XV,1154,240,183,90,14,13,540,1455
ENSENADA,XV,1155,320,116,89,15,6,546,1242
ENSENADA,XV,1156,302,164,90,16,7,579,1303
ENSENADA,XV,1157,357,346,151,14,12,880,2498
ENSENADA,XV,1158,175,126,66,7,10,384,1077
ENSENADA,XV,1159,203,179,84,14,8,488,1301
ENSENADA,XV,1160,203,144,70,6,5,428,1183
ENSENADA,XV,1161,134,167,43,8,6,358,960
ENSENADA,XV,1162,147,134,53,6,7,347,945
ENSENADA,XV,1163,351,381,247,18,19,1016,3210
ENSENADA,XV,1164,242,254,128,10,7,641,2393
ENSENADA,XV,1165,134,87,24,4,7,256,760
ENSENADA,XV,1166,119,110,31,5,5,270,966
ENSENADA,XV,1167,272,332,93,15,16,728,2893
ENSENADA,XV,1168,136,109,48,4,5,302,999
ENSENADA,XIV,1169,92,118,68,15,13,306,1058
ENSENADA,XIV,1170,73,90,74,24,10,271,877
ENSENADA,XIV,1171,140,207,117,12,23,499,1395
ENSENADA,XIV,1172,95,213,101,15,18,442,1366
ENSENADA,XIV,1173,148,224,111,7,18,508,1430
ENSENADA,XIV,1174,223,179,139,12,9,562,1414
ENSENADA,XIV,1175,126,246,47,8,16,443,1292
ENSENADA,XIV,1176,35,41,14,0,4,94,269
ENSENADA,XIV,1177,117,215,55,12,19,418,1308
ENSENADA,XIV,1178,56,89,27,3,8,183,648
ENSENADA,XIV,1179,55,89,28,3,5,180,449
ENSENADA,XIV,1180,145,121,57,3,7,333,1052
ENSENADA,XIV,1181,654,590,296,50,27,1617,4617
ENSENADA,XIV,1182,117,146,65,4,4,336,858
ENSENADA,XIV,1183,31,34,17,7,1,90,215
ENSENADA,XIV,1184,80,41,41,5,4,171,474
ENSENADA,XV,1185,172,238,101,11,11,533,1805
ENSENADA,XV,1186,129,111,25,6,12,283,1013
ENSENADA,XV,1187,89,152,28,4,6,279,838
ENSENADA,XV,1188,83,127,30,2,10,252,843
ENSENADA,XV,1189,79,88,39,3,4,213,783
ENSENADA,XV,1190,148,140,31,2,8,329,1176
ENSENADA,XV,1191,87,142,46,4,7,286,1131
ENSENADA,XV,1192,97,163,30,2,6,298,1111
ENSENADA,XV,1193,151,177,57,8,8,401,1423
ENSENADA,XV,1194,40,43,36,0,4,123,456
ENSENADA,XV,1195,39,32,54,1,4,130,448
ENSENADA,XV,1196,36,120,29,2,4,191,617
ENSENADA,XV,1197,57,189,62,6,9,323,876
ENSENADA,XV,1198,57,106,51,1,4,219,475
ENSENADA,XV,1199,49,117,49,1,5,221,891
ENSENADA,XV,1200,57,118,20,1,10,206,1004
ENSENADA,XV,1201,77,110,15,3,2,207,789
ENSENADA,XV,1202,134,67,29,2,15,247,1262
ENSENADA,XV,1203,200,115,24,4,11,354,1369
ENSENADA,XV,1204,85,118,81,1,15,300,1967
ENSENADA,XV,1205,127,150,20,2,4,303,1337
ENSENADA,XV,1206,98,87,17,0,5,207,685
ENSENADA,XV,1207,101,132,20,2,9,264,875
ENSENADA,XV,1208,105,96,28,3,6,238,750
ENSENADA,XV,1209,101,118,35,3,11,268,1678
ENSENADA,XV,1210,52,121,18,2,7,200,733
ENSENADA,XV,1211,91,137,26,3,5,262,1411
ENSENADA,XV,1212,76,70,23,5,3,177,775
ENSENADA,XV,1213,80,110,18,4,9,221,1007
ENSENADA,XV,1214,61,56,25,0,1,143,491
ENSENADA,XV,1215,54,50,30,1,4,139,549
ENSENADA,XV,1216,66,37,9,0,1,113,375
ENSENADA,XV,1217,219,402,78,10,23,732,2329
ENSENADA,XV,1218,31,212,11,1,7,262,558
ENSENADA,XV,1219,202,193,68,6,21,490,2219
ENSENADA,XV,1220,35,100,51,0,2,188,485
ENSENADA,XV,1221,65,137,43,0,4,249,586
ENSENADA,XV,1222,180,204,26,4,7,421,834
ENSENADA,XV,1223,28,121,38,0,3,190,498
ENSENADA,XV,1224,50,103,42,1,6,202,668
ENSENADA,XV,1225,28,34,45,0,1,108,258
ENSENADA,XV,1226,162,174,124,3,16,479,1973
ENSENADA,XV,1227,165,236,59,9,17,486,2031
ENSENADA,XV,1228,113,191,69,7,17,397,1866
ENSENADA,XV,1229,65,141,21,5,10,242,1054
ENSENADA,XV,1230,166,435,127,8,40,776,3421
ENSENADA,XV,1231,160,139,24,1,11,335,1379
ENSENADA,XV,1232,75,91,16,1,2,185,526
ENSENADA,XV,1233,299,299,78,16,15,707,2748
ENSENADA,XV,1234,165,235,68,3,25,496,1794
ENSENADA,XV,1235,118,181,38,2,17,356,1835
ENSENADA,XV,1236,44,70,27,1,6,148,602
ENSENADA,XV,1237,118,99,11,9,9,246,1152
ENSENADA,XV,1238,71,64,16,0,11,162,381
ENSENADA,XV,1239,219,127,127,3,13,489,1236
ENSENADA,XV,1240,40,61,7,0,1,109,228
ENSENADA,XV,1241,145,12,15,0,4,176,328
ENSENADA,XV,1242,66,40,14,0,4,124,359
ENSENADA,XV,1243,109,57,45,1,4,216,458
