MUNICIPIO,SECCION,CASILLA,PAN,PRI,PRD,PT,PVEM,PC,PSN,PAS,PD,VALIDOS,No Registrados,Nulos,Total,Comment
CANATLAN,1,B,137,170,47,23,1,0,0,0,2,380,0,6,386,
CANATLAN,2,B,104,124,22,9,0,0,0,1,0,260,0,6,266,
CANATLAN,2,C,140,106,19,5,0,0,0,0,2,272,1,3,276,
CANATLAN,3,B,133,169,19,20,0,0,0,0,1,342,0,5,347,
CANATLAN,3,C,112,140,28,27,1,0,0,0,1,309,0,6,315,
CANATLAN,4,B,136,109,21,19,2,0,0,6,2,295,0,10,305,
CANATLAN,5,B,103,160,17,14,3,0,0,0,0,297,0,3,300,
CANATLAN,5,C,107,156,32,10,2,0,0,0,0,307,0,5,312,
CANATLAN,6,B,129,176,22,26,0,0,0,0,2,355,0,0,355,
CANATLAN,6,C,158,167,34,33,0,0,0,2,2,396,0,13,409,
CANATLAN,7,B,99,175,36,20,1,0,0,0,0,331,0,11,342,
CANATLAN,8,B,46,121,2,1,0,0,0,0,0,170,0,0,170,
CANATLAN,8,C,54,115,3,1,1,0,0,3,0,177,0,3,180,
CANATLAN,9,B,115,149,38,19,1,0,0,0,1,323,0,13,336,
CANATLAN,10,B,22,71,0,1,0,0,0,0,0,94,0,7,101,
CANATLAN,11,B,12,30,0,9,1,0,0,0,3,55,0,1,56,
CANATLAN,12,B,37,12,3,4,0,0,0,1,0,57,0,1,58,
CANATLAN,13,B,98,142,3,25,2,0,0,1,5,276,0,0,276,
CANATLAN,14,B,79,152,8,7,1,0,0,0,2,249,0,0,249,
CANATLAN,15,B,36,112,11,35,0,0,0,1,0,195,0,2,197,
CANATLAN,15,X,44,26,5,3,0,0,0,0,0,78,0,3,81,
CANATLAN,15,X,28,23,6,48,0,0,0,0,0,105,0,4,109,
CANATLAN,16,B,12,41,0,0,0,0,0,0,0,53,0,0,53,
CANATLAN,16,X,14,31,0,0,0,0,0,1,0,46,0,2,48,
CANATLAN,16,X,4,43,0,2,0,0,0,0,0,49,0,1,50,
CANATLAN,17,B,43,29,0,3,0,0,0,0,1,76,0,0,76,
CANATLAN,18,B,12,20,4,1,0,0,0,0,0,37,0,4,41,
CANATLAN,22,X,37,69,5,1,0,0,0,0,0,112,0,0,112,
CANATLAN,23,B,104,124,11,13,0,0,0,3,1,256,0,11,267,
CANATLAN,24,B,59,96,2,35,1,0,0,1,1,195,0,6,201,
CANATLAN,25,B,75,110,77,7,5,0,0,8,9,291,0,9,300,
CANATLAN,26,B,57,70,7,30,0,0,0,0,3,167,0,9,176,
CANATLAN,26,C,72,75,4,26,3,0,0,0,0,180,0,5,185,
CANATLAN,27,B,63,83,13,11,2,0,0,0,0,172,3,9,184,
CANATLAN,27,C,85,94,7,7,2,0,0,0,3,198,0,18,216,
CANATLAN,28,B,138,125,17,12,2,0,0,0,1,295,0,3,298,
CANATLAN,29,B,88,92,17,11,2,0,0,1,0,211,0,8,219,
CANATLAN,29,C,111,87,19,20,3,0,0,1,1,242,0,6,248,
CANATLAN,30,B,81,75,16,22,0,0,0,3,5,202,0,6,208,
CANATLAN,30,C,111,80,9,19,2,0,0,5,1,227,0,3,230,
CANATLAN,31,B,107,137,24,23,3,0,0,1,3,298,0,6,304,
CANATLAN,32,B,61,65,9,25,1,0,0,0,2,163,0,1,164,
CANATLAN,33,B,34,58,10,1,0,0,0,1,4,108,0,0,108,
CANATLAN,34,B,9,53,0,3,0,0,0,0,0,65,0,0,65,
CANATLAN,35,B,14,72,5,3,0,0,0,15,1,110,0,1,111,
CANATLAN,36,B,5,36,0,2,0,0,0,0,3,46,0,0,46,
CANATLAN,37,B,50,109,4,29,0,0,0,1,4,197,0,4,201,
CANATLAN,37,C,63,133,6,15,2,0,0,0,4,223,0,2,225,
CANATLAN,38,B,95,114,0,36,0,0,0,0,0,245,0,21,266,
CANATLAN,39,B,6,76,2,34,0,0,0,0,1,119,0,0,119,
CANATLAN,40,B,67,77,5,0,0,0,0,0,1,150,0,5,155,
CANATLAN,40,X,42,52,17,15,0,0,0,0,0,126,0,3,129,
,,,,,,,,,,,,,,,,
,,,,,,,,,,,,,,,,
CANELAS,42,B,109,81,3,146,0,0,0,0,0,339,1,12,352,
CANELAS,43,B,13,3,0,32,0,0,0,0,0,48,5,1,54,
CANELAS,44,B,38,24,0,62,0,0,0,0,0,124,6,6,136,
CANELAS,45,B,13,5,0,24,0,0,0,0,0,42,0,1,43,
CANELAS,46,B,19,4,0,18,0,0,0,0,0,41,0,1,42,
CANELAS,47,B,42,11,0,45,0,0,0,0,0,98,0,0,98,
CANELAS,48,B,44,10,0,52,0,0,0,0,0,106,0,4,110,
CANELAS,50,B,4,10,1,45,0,0,0,0,0,60,5,1,66,
CANELAS,51,B,11,4,0,6,0,0,0,0,0,21,0,0,21,
CANELAS,52,B,1,25,0,18,0,0,0,0,0,44,0,0,44,
CANELAS,53,B,64,21,2,12,0,0,0,0,0,99,0,7,106,
CANELAS,54,B,18,4,1,14,0,0,0,0,0,37,0,2,39,
CANELAS,55,B,15,12,0,64,0,0,0,0,0,91,0,2,93,
CANELAS,56,B,31,26,2,66,0,0,0,0,0,125,0,4,129,
,,,,,,,,,,,,,,,,
CONETO DE COMONFORT,57,B,36,106,1,40,0,0,0,0,145,328,0,1,329,
CONETO DE COMONFORT,58,B,0,46,0,42,0,0,0,0,43,131,0,2,133,
CONETO DE COMONFORT,59,B,3,22,0,4,0,0,0,0,41,70,0,0,70,
CONETO DE COMONFORT,60,B,46,72,0,27,0,0,0,0,45,190,0,3,193,
CONETO DE COMONFORT,61,B,4,10,0,12,0,0,0,0,33,59,0,0,59,
CONETO DE COMONFORT,62,B,44,35,0,17,0,0,0,0,26,122,0,26,148,
CONETO DE COMONFORT,63,B,18,150,1,190,0,0,0,0,81,440,0,5,445,
CONETO DE COMONFORT,63,X,2,19,0,14,0,0,0,0,4,39,0,1,40,
CONETO DE COMONFORT,64,B,8,34,2,21,0,0,0,0,69,134,0,0,134,
CONETO DE COMONFORT,65,B,5,80,1,20,0,0,0,0,83,189,0,0,189,
,,,,,,,,,,,,,,,,
CUENCAME,66,B,129,177,21,10,0,0,0,4,3,344,0,10,354,
CUENCAME,66,C,145,163,24,4,0,0,0,3,3,342,0,5,347,
CUENCAME,67,B,97,103,10,3,0,0,0,1,4,218,0,10,228,
CUENCAME,67,C,119,90,14,1,0,0,0,0,4,228,0,0,228,
CUENCAME,68,B,110,83,13,2,0,0,0,2,0,210,0,3,213,
CUENCAME,68,C,94,115,21,1,0,0,0,1,3,235,0,10,245,
CUENCAME,69,B,174,219,14,14,0,0,0,3,2,426,0,8,434,
CUENCAME,69,C,136,226,28,10,0,0,0,3,9,412,0,10,422,
CUENCAME,70,B,168,181,24,6,0,0,0,5,0,384,1,14,399,
CUENCAME,71,B,12,10,0,4,0,0,0,0,0,26,0,0,26,
CUENCAME,72,B,84,84,3,4,0,0,0,0,0,175,0,6,181,
CUENCAME,73,B,53,75,11,8,0,0,0,7,0,154,0,7,161,
CUENCAME,73,C,53,59,14,10,0,0,0,5,0,141,0,9,150,
CUENCAME,74,B,76,30,0,1,0,0,0,2,1,110,0,1,111,
CUENCAME,75,B,110,152,11,8,0,0,0,1,1,283,0,8,291,
CUENCAME,76,B,75,63,0,1,0,0,0,1,1,141,0,8,149,
CUENCAME,76,C,70,80,1,5,0,0,0,0,0,156,0,8,164,
CUENCAME,77,B,53,47,0,2,0,0,0,2,0,104,0,2,106,
CUENCAME,78,,69,92,1,17,0,0,0,0,0,179,0,17,196,
CUENCAME,79,B,62,59,0,10,0,0,0,0,0,131,0,3,134,
CUENCAME,80,B,103,127,2,2,0,0,0,1,0,235,0,9,244,
CUENCAME,80,C,106,112,2,2,0,0,0,0,0,222,0,5,227,
CUENCAME,81,B,42,107,2,2,0,0,0,1,0,154,0,0,154,
CUENCAME,82,B,18,35,1,0,0,0,0,0,1,55,0,1,56,
CUENCAME,82,X,44,7,5,1,0,0,0,0,0,57,0,1,58,
CUENCAME,83,B,62,60,2,2,0,0,0,1,2,129,0,2,131,
CUENCAME,84,B,44,88,14,2,0,0,0,0,0,148,0,0,148,
CUENCAME,85,B,36,43,6,4,0,0,0,0,0,89,0,4,93,
CUENCAME,86,B,42,62,2,4,0,0,0,5,0,115,0,0,115,
CUENCAME,87,B,59,105,0,2,0,0,0,12,0,178,0,4,182,
CUENCAME,88,B,12,27,2,0,0,0,0,0,0,41,0,1,42,
CUENCAME,89,B,26,66,2,4,0,0,0,0,1,99,0,1,100,
CUENCAME,90,B,59,51,0,4,0,0,0,2,0,116,0,0,116,
CUENCAME,91,B,58,84,3,8,0,0,0,0,1,154,0,1,155,
CUENCAME,92,B,26,25,0,6,0,0,0,0,1,58,0,2,60,
CUENCAME,93,B,11,35,0,3,0,0,0,0,1,50,0,0,50,
CUENCAME,94,B,151,119,1,3,0,0,0,0,1,275,0,2,277,
CUENCAME,95,B,51,89,1,11,0,0,0,0,0,152,0,1,153,
CUENCAME,95,C,70,75,2,2,0,0,0,1,0,150,0,5,155,
CUENCAME,96,B,64,92,1,65,0,0,0,0,0,222,0,6,228,
CUENCAME,97,B,127,76,2,2,0,0,0,1,0,208,0,9,217,
CUENCAME,97,X,22,26,0,2,0,0,0,0,1,51,0,1,52,
CUENCAME,98,B,5,19,1,3,0,0,0,0,0,28,0,0,28,
CUENCAME,99,B,88,66,8,4,0,0,0,0,1,167,0,2,169,
CUENCAME,99,C,84,98,6,0,0,0,0,0,2,190,0,4,194,
CUENCAME,100,B,53,73,6,3,0,0,0,0,0,135,0,4,139,
CUENCAME,100,C,59,85,8,4,0,0,0,1,0,157,0,9,166,
CUENCAME,101,B,92,91,6,5,0,0,0,0,0,194,0,5,199,
CUENCAME,102,B,94,95,3,2,0,0,0,0,0,194,0,0,194,
CUENCAME,103,B,176,84,2,8,0,0,0,1,1,272,1,8,281,
CUENCAME,104,B,24,69,3,0,0,0,0,0,0,96,0,19,115,
CUENCAME,105,B,109,116,46,7,0,0,0,0,0,278,0,8,286,
CUENCAME,106,B,99,53,18,4,0,0,0,0,0,174,0,9,183,
CUENCAME,107,B,49,26,0,16,0,0,0,0,0,91,0,4,95,
,,,,,,,,,,,,,,,,
SIMON BOLIVAR,420,B,11,104,101,2,0,0,0,0,4,222,0,5,227,
SIMON BOLIVAR,420,C,12,124,103,2,0,0,0,0,8,249,0,0,249,
SIMON BOLIVAR,421,B,11,20,3,1,0,0,0,0,2,37,0,0,37,
SIMON BOLIVAR,422,B,12,293,40,6,0,0,0,0,11,362,0,15,377,
SIMON BOLIVAR,423,B,17,62,60,10,0,0,0,0,0,149,0,0,149,
SIMON BOLIVAR,424,B,6,253,19,16,0,0,0,0,9,303,0,0,303,
SIMON BOLIVAR,425,B,11,123,15,8,0,0,0,0,17,174,0,5,179,
SIMON BOLIVAR,426,B,19,175,7,4,0,0,0,0,202,407,4,3,414,
SIMON BOLIVAR,427,B,30,93,13,5,0,0,0,0,16,157,0,0,157,
SIMON BOLIVAR,428,B,3,62,5,2,0,0,0,0,1,73,0,2,75,
SIMON BOLIVAR,428,X,3,40,11,1,0,0,0,0,5,60,0,4,64,
SIMON BOLIVAR,429,B,22,57,9,4,0,0,0,0,17,109,0,13,122,
SIMON BOLIVAR,429,X,3,58,9,3,0,0,0,0,0,73,0,5,78,
SIMON BOLIVAR,429,X,3,70,3,1,0,0,0,0,10,87,0,2,89,
SIMON BOLIVAR,430,B,9,76,27,1,0,0,0,0,14,127,0,0,127,
SIMON BOLIVAR,430,X,1,45,24,2,0,0,0,0,0,72,0,0,72,
SIMON BOLIVAR,431,B,36,206,84,11,0,0,0,0,7,344,0,5,349,
SIMON BOLIVAR,432,B,5,55,2,1,0,0,0,0,5,68,0,1,69,
SIMON BOLIVAR,433,B,3,62,26,7,0,0,0,0,2,100,0,2,102,
SIMON BOLIVAR,434,B,6,52,22,1,0,0,0,0,3,84,0,4,88,
SIMON BOLIVAR,435,B,6,90,39,1,0,0,0,0,11,147,0,0,147,
SIMON BOLIVAR,435,C,3,85,48,2,0,0,0,0,12,150,5,11,166,
SIMON BOLIVAR,435,X,23,50,11,5,0,0,0,0,1,90,0,1,91,
,,,,,,,,,,,,,,,,
GOMEZ PALACIO,436,B,69,220,9,0,1,0,0,0,0,299,0,2,301,
GOMEZ PALACIO,437,B,123,181,26,0,6,0,0,0,17,353,0,0,353,
GOMEZ PALACIO,438,B,35,178,5,4,0,0,0,0,1,223,0,8,231,
GOMEZ PALACIO,438,C,39,186,8,1,0,0,0,0,5,239,0,5,244,
GOMEZ PALACIO,439,B,54,224,5,0,0,0,0,0,5,288,0,4,292,
GOMEZ PALACIO,439,C,53,200,3,0,2,0,0,1,3,262,0,1,263,
GOMEZ PALACIO,439,C,48,219,4,3,0,0,0,0,6,280,0,2,282,
GOMEZ PALACIO,439,C,127,367,6,2,0,0,0,0,13,515,0,15,530,
GOMEZ PALACIO,440,B,46,140,0,0,0,0,0,2,3,191,0,8,199,
GOMEZ PALACIO,440,C,26,164,1,1,1,0,0,0,2,195,0,1,196,
GOMEZ PALACIO,441,B,11,127,1,0,0,0,0,1,5,145,0,1,146,
GOMEZ PALACIO,441,C,24,121,3,1,1,0,0,0,8,158,0,3,161,
GOMEZ PALACIO,442,B,67,229,2,0,1,0,0,1,14,314,1,6,321,
GOMEZ PALACIO,443,B,24,173,2,1,1,0,0,0,0,201,0,0,201,
GOMEZ PALACIO,443,C,29,182,1,0,1,0,0,0,8,221,0,5,226,
GOMEZ PALACIO,443,C,32,131,1,3,0,0,0,1,3,171,0,0,171,
GOMEZ PALACIO,444,B,33,195,0,1,2,0,0,3,5,239,0,3,242,
GOMEZ PALACIO,445,B,53,156,3,1,8,0,0,2,18,241,0,5,246,
GOMEZ PALACIO,445,C,20,96,2,0,3,0,0,0,2,123,0,2,125,
GOMEZ PALACIO,446,C,25,116,7,23,14,0,0,0,4,189,0,7,196,
GOMEZ PALACIO,446,C,15,176,5,24,13,0,0,0,8,241,0,6,247,
GOMEZ PALACIO,446,B,28,184,0,23,7,0,0,0,3,245,0,5,250,
GOMEZ PALACIO,447,B,51,223,8,3,2,0,0,0,5,292,0,2,294,
GOMEZ PALACIO,447,C,61,213,3,1,3,0,0,1,4,286,0,0,286,
GOMEZ PALACIO,447,C,53,234,6,0,0,0,0,1,2,296,0,1,297,
GOMEZ PALACIO,447,C,58,231,1,1,3,0,0,1,3,298,0,2,300,
GOMEZ PALACIO,447,C,63,218,10,2,2,0,0,0,1,296,0,1,297,
GOMEZ PALACIO,448,B,65,199,5,0,0,0,0,0,4,273,0,2,275,
GOMEZ PALACIO,448,C,45,225,5,0,3,0,0,0,1,279,0,1,280,
GOMEZ PALACIO,449,B,57,175,6,3,1,0,0,1,0,243,0,7,250,
GOMEZ PALACIO,449,C,61,161,9,1,3,0,0,0,3,238,0,3,241,
GOMEZ PALACIO,450,B,61,145,3,3,2,0,0,0,3,217,0,0,217,
GOMEZ PALACIO,450,C,56,158,5,1,1,0,0,0,4,225,0,5,230,
GOMEZ PALACIO,451,B,51,190,1,3,2,0,0,1,1,249,0,5,254,
GOMEZ PALACIO,451,C,54,200,6,0,3,0,0,1,3,267,0,6,273,
GOMEZ PALACIO,452,B,44,164,7,2,1,0,0,1,12,231,0,0,231,
GOMEZ PALACIO,452,C,42,167,2,2,1,0,0,1,2,217,0,5,222,
GOMEZ PALACIO,452,C,39,183,3,0,3,0,0,0,1,229,0,5,234,
GOMEZ PALACIO,453,B,81,214,7,0,3,0,0,0,3,308,0,5,313,
GOMEZ PALACIO,453,C,67,223,7,0,2,0,0,0,5,304,0,9,313,
GOMEZ PALACIO,454,B,8,104,6,0,2,0,1,0,17,138,0,5,143,
GOMEZ PALACIO,454,C,15,112,1,0,1,0,0,0,17,146,0,2,148,
GOMEZ PALACIO,455,B,65,216,3,1,0,0,0,2,6,293,0,7,300,
GOMEZ PALACIO,456,B,10,180,0,2,7,0,0,3,13,215,0,7,222,
GOMEZ PALACIO,457,B,14,106,1,0,0,0,0,0,13,134,0,5,139,
GOMEZ PALACIO,458,B,27,206,6,1,0,0,0,5,11,256,0,3,259,
GOMEZ PALACIO,459,B,37,170,6,5,3,0,0,1,6,228,0,2,230,
GOMEZ PALACIO,459,C,35,167,2,2,5,0,0,0,8,219,0,7,226,
GOMEZ PALACIO,460,B,18,205,2,1,0,0,0,0,8,234,0,7,241,
GOMEZ PALACIO,460,C,21,186,2,1,2,0,0,0,5,217,0,4,221,
GOMEZ PALACIO,461,B,37,170,1,0,2,0,0,1,5,216,0,7,223,
GOMEZ PALACIO,461,C,49,177,1,0,2,0,0,3,3,235,0,1,236,
GOMEZ PALACIO,462,B,33,149,0,0,0,0,0,0,2,184,0,1,185,
GOMEZ PALACIO,462,C,38,136,0,0,0,0,0,0,3,177,0,0,177,
GOMEZ PALACIO,463,B,40,114,1,0,1,0,0,1,3,160,0,3,163,
GOMEZ PALACIO,463,C,30,111,3,2,0,0,0,2,2,150,0,2,152,
GOMEZ PALACIO,464,B,45,143,0,0,1,0,0,0,2,191,0,1,192,
GOMEZ PALACIO,464,C,34,180,0,0,1,0,2,0,1,218,0,2,220,
GOMEZ PALACIO,465,B,52,135,4,0,1,0,0,5,2,199,0,3,202,
GOMEZ PALACIO,466,B,60,156,1,0,0,0,0,2,2,221,0,2,223,
GOMEZ PALACIO,467,B,151,317,4,2,9,0,0,5,9,497,0,6,503,
GOMEZ PALACIO,467,C,60,161,1,0,4,0,0,1,2,229,0,4,233,
GOMEZ PALACIO,468,B,51,179,5,1,0,0,0,7,6,249,0,3,252,
GOMEZ PALACIO,469,B,48,228,4,2,0,0,0,1,8,291,0,7,298,
GOMEZ PALACIO,470,B,34,152,2,0,0,0,0,0,6,194,0,5,199,
GOMEZ PALACIO,471,B,51,159,2,0,3,0,0,0,4,219,0,8,227,
GOMEZ PALACIO,471,C,70,190,3,0,1,0,0,1,6,271,0,3,274,
GOMEZ PALACIO,472,B,56,247,6,0,3,0,0,2,5,319,0,7,326,
GOMEZ PALACIO,472,C,59,207,3,0,1,0,0,2,13,285,0,6,291,
GOMEZ PALACIO,473,B,46,181,2,1,3,0,0,1,11,245,0,0,245,
GOMEZ PALACIO,473,C,72,176,0,2,0,0,0,1,5,256,0,4,260,
GOMEZ PALACIO,473,C,47,207,1,0,1,0,0,0,4,260,0,3,263,
GOMEZ PALACIO,474,B,73,200,5,0,1,0,0,0,10,289,0,8,297,
GOMEZ PALACIO,474,C,60,208,2,0,1,0,0,0,7,278,0,5,283,
GOMEZ PALACIO,475,B,67,205,7,1,1,0,0,0,6,287,0,3,290,
GOMEZ PALACIO,475,C,55,197,1,0,0,0,0,0,10,263,0,8,271,
GOMEZ PALACIO,476,B,19,132,3,0,0,0,0,0,4,158,0,7,165,
GOMEZ PALACIO,476,C,18,141,0,1,0,0,0,1,4,165,0,8,173,
GOMEZ PALACIO,477,B,29,149,0,0,0,0,0,1,5,184,0,5,189,
GOMEZ PALACIO,478,B,57,194,5,0,0,0,0,0,6,262,0,6,268,
GOMEZ PALACIO,479,B,33,123,3,2,1,0,0,2,4,168,0,7,175,
GOMEZ PALACIO,479,C,25,110,4,0,3,0,0,0,3,145,0,4,149,
GOMEZ PALACIO,480,B,36,141,1,1,0,0,0,2,1,182,0,0,182,
GOMEZ PALACIO,480,C,35,137,4,2,1,0,0,0,2,181,0,3,184,
GOMEZ PALACIO,481,B,42,127,4,1,1,0,0,3,1,179,0,4,183,
GOMEZ PALACIO,481,C,57,120,4,0,1,0,0,4,1,187,0,0,187,
GOMEZ PALACIO,482,B,41,131,2,0,2,0,0,4,3,183,0,1,184,
GOMEZ PALACIO,482,C,51,171,1,1,1,0,0,0,1,226,0,2,228,
GOMEZ PALACIO,483,B,42,121,1,1,0,0,0,3,2,170,0,5,175,
GOMEZ PALACIO,483,C,37,116,0,0,1,0,0,0,2,156,0,5,161,
GOMEZ PALACIO,484,B,56,129,2,0,0,0,0,1,10,198,0,3,201,
GOMEZ PALACIO,484,C,53,150,1,2,0,0,0,0,2,208,0,4,212,
GOMEZ PALACIO,485,B,38,172,1,2,1,0,0,1,6,221,0,8,229,
GOMEZ PALACIO,485,C,51,191,2,1,0,0,0,0,1,246,0,9,255,
GOMEZ PALACIO,486,B,39,212,1,0,1,0,0,1,8,262,0,4,266,
GOMEZ PALACIO,486,C,55,193,5,2,0,0,0,0,7,262,0,8,270,
GOMEZ PALACIO,487,B,36,156,9,0,5,0,0,0,1,207,0,8,215,
GOMEZ PALACIO,487,C,33,163,10,3,0,0,0,0,4,213,0,8,221,
GOMEZ PALACIO,488,B,27,139,1,1,1,0,0,0,1,170,0,5,175,
GOMEZ PALACIO,488,C,31,126,2,1,1,0,0,1,5,167,0,4,171,
GOMEZ PALACIO,488,C,21,157,4,1,2,0,0,0,1,186,0,2,188,
GOMEZ PALACIO,489,B,14,103,1,1,3,0,0,0,3,125,0,0,125,
GOMEZ PALACIO,489,C,14,116,3,1,2,0,0,0,1,137,0,1,138,
GOMEZ PALACIO,490,B,12,107,0,2,0,0,0,0,0,121,0,6,127,
GOMEZ PALACIO,490,C,12,111,7,1,0,0,0,0,3,134,0,3,137,
GOMEZ PALACIO,491,B,22,113,2,14,3,0,0,0,5,159,0,10,169,
GOMEZ PALACIO,491,C,24,149,2,7,0,0,0,0,1,183,0,4,187,
GOMEZ PALACIO,491,C,29,118,3,17,3,0,0,0,2,172,0,7,179,
GOMEZ PALACIO,492,B,29,186,4,2,3,0,0,0,5,229,0,5,234,
GOMEZ PALACIO,492,C,31,174,4,0,0,0,0,0,6,215,0,0,215,
GOMEZ PALACIO,493,B,38,143,2,3,0,0,0,1,7,194,0,7,201,
GOMEZ PALACIO,493,C,36,146,1,4,1,0,0,0,4,192,0,4,196,
GOMEZ PALACIO,494,B,57,168,2,0,3,0,0,1,4,235,0,4,239,
GOMEZ PALACIO,494,C,61,162,3,1,3,0,0,0,4,234,0,4,238,
GOMEZ PALACIO,495,B,61,162,1,0,1,0,0,0,3,228,0,4,232,
GOMEZ PALACIO,495,C,78,159,1,0,5,0,0,0,4,247,0,4,251,
GOMEZ PALACIO,496,B,85,249,0,1,2,0,0,0,4,341,0,6,347,
GOMEZ PALACIO,497,B,54,176,3,3,2,0,0,0,3,241,0,6,247,
GOMEZ PALACIO,498,B,68,124,4,2,2,0,0,0,7,207,0,2,209,
GOMEZ PALACIO,498,C,77,141,4,2,0,0,0,1,6,231,0,4,235,
GOMEZ PALACIO,499,B,29,149,2,1,2,0,0,0,6,189,0,7,196,
GOMEZ PALACIO,499,C,41,166,0,1,2,0,0,0,8,218,0,4,222,
GOMEZ PALACIO,500,B,41,178,9,0,2,0,0,1,4,235,0,4,239,
GOMEZ PALACIO,500,C,47,175,2,0,1,0,0,0,2,227,0,4,231,
GOMEZ PALACIO,501,B,51,174,5,3,0,0,0,0,2,235,0,5,240,
GOMEZ PALACIO,501,C,58,167,4,0,1,0,0,1,2,233,0,9,242,
GOMEZ PALACIO,502,B,76,191,2,1,2,0,0,0,5,277,0,3,280,
GOMEZ PALACIO,502,C,71,221,5,2,2,0,0,0,4,305,0,2,307,
GOMEZ PALACIO,502,C,65,191,7,1,2,0,0,0,8,274,0,2,276,
GOMEZ PALACIO,503,B,55,189,6,0,0,0,0,0,2,252,0,0,252,
GOMEZ PALACIO,503,C,61,172,2,0,0,0,0,1,2,238,0,4,242,
GOMEZ PALACIO,504,B,52,132,2,0,1,0,0,0,8,195,0,3,198,
GOMEZ PALACIO,504,C,60,149,3,3,0,0,0,0,4,219,0,5,224,
GOMEZ PALACIO,505,B,82,146,7,0,1,0,0,0,2,238,0,7,245,
GOMEZ PALACIO,505,C,79,176,6,1,1,0,0,0,2,265,0,2,267,
GOMEZ PALACIO,506,B,55,136,0,2,0,0,0,1,4,198,0,7,205,
GOMEZ PALACIO,506,C,52,154,4,0,2,0,0,0,3,215,0,4,219,
GOMEZ PALACIO,507,B,63,123,6,1,0,0,0,0,6,199,0,3,202,
GOMEZ PALACIO,507,C,45,155,6,0,2,0,0,0,3,211,0,5,216,
GOMEZ PALACIO,508,B,75,205,4,1,2,0,0,0,3,290,0,6,296,
GOMEZ PALACIO,509,B,47,233,2,5,2,0,0,0,14,303,0,7,310,
GOMEZ PALACIO,510,B,40,172,5,2,0,0,0,1,15,235,0,2,237,
GOMEZ PALACIO,510,C.,37,161,10,3,1,0,0,0,12,224,0,2,226,
GOMEZ PALACIO,510,C,37,114,5,2,0,1,0,1,30,190,0,12,202,
GOMEZ PALACIO,511,B,30,98,12,2,0,0,0,0,4,146,0,3,149,
GOMEZ PALACIO,511,C,26,108,10,2,0,0,0,0,5,151,0,4,155,
GOMEZ PALACIO,512,B,17,101,0,21,0,0,0,0,3,142,0,2,144,
GOMEZ PALACIO,512,C,23,113,3,21,0,0,0,0,0,160,0,6,166,
GOMEZ PALACIO,513,B,27,141,1,3,0,0,0,1,1,174,0,11,185,
GOMEZ PALACIO,513,C,20,108,1,4,1,0,0,0,6,140,0,12,152,
GOMEZ PALACIO,514,B,56,183,3,1,1,0,0,1,25,270,0,13,283,
GOMEZ PALACIO,515,B,68,187,9,1,1,0,0,1,16,283,0,11,294,
GOMEZ PALACIO,515,C,41,194,1,1,1,0,0,5,11,254,0,0,254,
GOMEZ PALACIO,516,B,52,183,3,0,2,0,0,1,6,247,0,9,256,
GOMEZ PALACIO,517,B,107,185,7,0,0,0,0,0,5,304,1,4,309,
GOMEZ PALACIO,518,B,58,152,2,1,1,0,0,0,1,215,0,4,219,
GOMEZ PALACIO,519,B,65,167,5,0,1,0,0,2,3,243,0,3,246,
GOMEZ PALACIO,519,C,75,159,2,1,0,0,0,0,3,240,0,2,242,
GOMEZ PALACIO,520,B,64,183,4,0,1,0,0,0,2,254,0,4,258,
GOMEZ PALACIO,520,C,64,185,3,1,0,0,0,0,2,255,0,5,260,
GOMEZ PALACIO,521,B,40,194,5,1,1,0,0,0,1,242,0,5,247,
GOMEZ PALACIO,521,C,27,191,1,0,1,0,0,1,0,221,0,9,230,
GOMEZ PALACIO,522,B,63,181,0,0,0,0,0,1,2,247,0,4,251,
GOMEZ PALACIO,522,C,66,146,0,1,1,0,0,1,5,220,0,3,223,
GOMEZ PALACIO,523,B,50,131,1,1,3,0,0,1,2,189,0,4,193,
GOMEZ PALACIO,523,C,40,123,1,1,0,0,0,0,2,167,0,1,168,
GOMEZ PALACIO,524,B,50,198,2,0,0,0,0,0,5,255,0,6,261,
GOMEZ PALACIO,525,B,38,198,4,2,2,0,0,0,5,249,0,6,255,
GOMEZ PALACIO,525,C,41,231,3,5,0,0,0,2,7,289,0,6,295,
GOMEZ PALACIO,526,B,20,88,2,22,0,0,0,0,5,137,0,1,138,
GOMEZ PALACIO,526,C,24,78,2,34,0,0,0,0,6,144,0,1,145,
GOMEZ PALACIO,527,B,40,99,1,1,1,0,0,0,10,152,0,0,152,
GOMEZ PALACIO,527,C,36,107,1,0,1,0,0,0,4,149,0,2,151,
GOMEZ PALACIO,528,B,13,143,5,0,2,0,0,0,4,167,0,4,171,
GOMEZ PALACIO,528,C,18,132,1,1,0,0,0,0,6,158,0,0,158,
GOMEZ PALACIO,529,B,36,124,3,0,1,0,0,0,1,165,4,3,172,
GOMEZ PALACIO,529,C,30,143,1,0,1,0,0,0,2,177,0,2,179,
GOMEZ PALACIO,530,B,47,190,4,1,3,0,0,0,0,245,0,4,249,
GOMEZ PALACIO,530,C,44,200,5,1,1,0,0,0,2,253,0,7,260,
GOMEZ PALACIO,531,B,32,185,4,0,1,0,0,0,3,225,0,5,230,
GOMEZ PALACIO,531,C,28,207,5,0,0,0,0,0,2,242,0,3,245,
GOMEZ PALACIO,532,B,80,177,6,2,2,0,0,0,4,271,0,5,276,
GOMEZ PALACIO,533,B,55,126,0,0,0,0,0,0,0,181,0,3,184,
GOMEZ PALACIO,533,C,73,108,1,0,1,0,0,0,4,187,1,0,188,
GOMEZ PALACIO,534,B,73,195,6,1,5,0,0,1,5,286,0,1,287,
GOMEZ PALACIO,535,B,125,214,0,2,3,0,0,1,2,347,0,3,350,
GOMEZ PALACIO,535,C,131,206,2,0,2,0,0,0,5,346,0,2,348,
GOMEZ PALACIO,536,B,107,166,3,0,1,0,0,0,7,284,1,3,288,
GOMEZ PALACIO,536,C,117,166,6,0,4,0,0,0,5,298,0,5,303,
GOMEZ PALACIO,537,B,82,111,2,1,0,0,0,0,3,199,0,3,202,
GOMEZ PALACIO,537,C,63,130,5,2,1,0,0,0,3,204,0,4,208,
GOMEZ PALACIO,538,B,61,151,4,1,1,0,0,0,2,220,0,4,224,
GOMEZ PALACIO,538,C,58,152,1,0,0,0,0,0,1,212,0,3,215,
GOMEZ PALACIO,539,B,34,134,6,0,1,0,0,1,1,177,0,4,181,
GOMEZ PALACIO,539,C,32,131,3,2,0,0,0,0,7,175,0,4,179,
GOMEZ PALACIO,540,B,67,209,4,0,0,0,0,0,4,284,0,9,293,
GOMEZ PALACIO,541,B,40,209,6,0,1,0,0,0,3,259,0,0,259,
GOMEZ PALACIO,541,C,58,220,5,0,3,0,0,0,0,286,0,5,291,
GOMEZ PALACIO,541,C,53,205,1,3,0,0,0,3,3,268,0,4,272,
GOMEZ PALACIO,541,C,39,219,2,1,1,0,0,1,4,267,0,5,272,
GOMEZ PALACIO,542,B,45,112,0,0,2,0,0,1,4,164,0,4,168,
GOMEZ PALACIO,542,C,51,121,3,0,0,0,0,1,7,183,0,1,184,
GOMEZ PALACIO,543,B,60,200,4,2,4,0,0,0,4,274,0,1,275,
GOMEZ PALACIO,544,B,32,138,1,0,0,0,1,0,1,173,0,4,177,
GOMEZ PALACIO,544,C,31,135,0,0,1,0,0,0,4,171,0,1,172,
GOMEZ PALACIO,545,B,56,187,0,1,0,0,0,1,4,249,0,1,250,
GOMEZ PALACIO,546,B,113,242,3,0,1,0,0,0,1,360,0,3,363,
GOMEZ PALACIO,547,B,53,258,9,1,7,2,0,0,2,332,0,6,338,
GOMEZ PALACIO,548,B,31,156,3,2,1,0,0,0,0,193,0,2,195,
GOMEZ PALACIO,548,C,21,147,5,4,0,0,0,0,0,177,0,3,180,
GOMEZ PALACIO,549,B,46,153,13,0,1,0,0,0,1,214,0,10,224,
GOMEZ PALACIO,550,B,27,171,3,3,3,0,0,0,1,208,0,3,211,
GOMEZ PALACIO,550,C,37,140,5,0,1,0,0,1,0,184,0,0,184,
GOMEZ PALACIO,551,B,21,167,1,0,1,0,0,0,2,192,0,2,194,
GOMEZ PALACIO,551,C,30,141,2,2,2,0,0,0,3,180,0,3,183,
GOMEZ PALACIO,552,B,101,179,1,2,5,0,0,0,0,288,0,2,290,
GOMEZ PALACIO,552,C,113,177,3,0,3,0,0,1,1,298,0,9,307,
GOMEZ PALACIO,553,B,20,146,4,0,1,0,0,0,3,174,0,2,176,
GOMEZ PALACIO,553,C,22,149,2,2,4,0,0,0,0,179,0,0,179,
GOMEZ PALACIO,554,B,42,194,11,4,4,0,0,0,1,256,0,0,256,
GOMEZ PALACIO,555,B,33,111,4,0,1,0,0,0,2,151,0,1,152,
GOMEZ PALACIO,556,B,15,105,21,1,1,0,0,0,0,143,0,0,143,
GOMEZ PALACIO,557,B,18,32,5,0,0,0,0,0,0,55,0,0,55,
GOMEZ PALACIO,558,B,41,118,3,0,0,0,0,0,1,163,0,2,165,
GOMEZ PALACIO,558,C,27,124,4,1,1,0,0,0,5,162,0,2,164,
GOMEZ PALACIO,559,B,57,137,3,0,0,0,0,0,0,197,1,5,203,
GOMEZ PALACIO,559,C,102,107,5,0,0,0,0,0,1,215,0,0,215,
GOMEZ PALACIO,560,B,40,115,21,1,0,0,0,0,3,180,0,3,183,
GOMEZ PALACIO,560,C,43,102,15,0,0,0,0,0,4,164,0,0,164,
GOMEZ PALACIO,561,B,49,196,24,3,1,0,0,0,13,286,0,5,291,
GOMEZ PALACIO,561,X,110,248,7,1,1,0,0,0,0,367,0,17,384,
GOMEZ PALACIO,562,B,9,129,31,0,2,0,0,0,11,182,0,0,182,
GOMEZ PALACIO,562,C,26,150,20,3,0,0,0,0,1,200,0,1,201,
GOMEZ PALACIO,563,B,23,146,51,0,0,0,0,0,1,221,0,0,221,
GOMEZ PALACIO,564,B,32,109,1,0,1,0,0,0,7,150,0,0,150,
GOMEZ PALACIO,564,C,53,118,4,1,3,0,0,0,0,179,0,2,181,
GOMEZ PALACIO,565,B,73,121,0,1,0,0,0,0,0,195,0,5,200,
GOMEZ PALACIO,565,C,60,156,1,1,1,0,0,0,0,219,0,0,219,
GOMEZ PALACIO,566,B,33,178,5,10,1,0,0,0,1,228,0,8,236,
GOMEZ PALACIO,566,C,16,193,4,17,2,0,0,0,3,235,0,0,235,
GOMEZ PALACIO,567,B,43,151,8,0,2,0,0,0,12,216,0,7,223,
GOMEZ PALACIO,567,C,41,146,10,2,1,0,0,0,6,206,0,8,214,
GOMEZ PALACIO,568,B,39,104,3,1,0,0,0,0,0,147,0,6,153,
GOMEZ PALACIO,569,B,12,167,2,4,2,0,0,0,2,189,0,8,197,
GOMEZ PALACIO,569,C,17,130,3,2,0,0,0,0,2,154,9,2,165,
GOMEZ PALACIO,570,B,85,216,4,2,4,0,0,1,3,315,0,9,324,
GOMEZ PALACIO,571,B,64,241,3,3,7,0,0,0,1,319,0,4,323,
GOMEZ PALACIO,571,X,17,195,8,0,2,0,0,0,0,222,0,2,224,
GOMEZ PALACIO,572,B,25,239,5,1,16,0,0,2,9,297,0,0,297,
GOMEZ PALACIO,573,B,16,115,5,2,1,0,0,1,6,146,0,3,149,
GOMEZ PALACIO,573,X,8,119,3,2,1,0,0,0,0,133,0,1,134,
GOMEZ PALACIO,574,B,13,164,10,0,1,0,0,0,10,198,0,8,206,
GOMEZ PALACIO,574,C,19,134,5,0,1,0,0,0,6,165,0,5,170,
GOMEZ PALACIO,574,C,26,141,4,3,0,0,0,0,8,182,0,6,188,
GOMEZ PALACIO,575,B,79,135,11,2,17,0,0,0,0,244,0,0,244,
GOMEZ PALACIO,576,B,30,0,9,0,0,0,0,0,1,40,0,0,40,
GOMEZ PALACIO,577,B,9,248,11,0,0,0,0,0,1,269,0,0,269,
GOMEZ PALACIO,578,B,24,124,18,8,12,0,0,0,1,187,1,7,195,
GOMEZ PALACIO,579,B,35,145,3,0,28,0,0,0,0,211,6,3,220,
GOMEZ PALACIO,579,X,27,169,4,2,8,0,0,0,0,210,0,3,213,
GOMEZ PALACIO,580,B,93,143,17,0,8,0,0,1,1,263,0,8,271,
GOMEZ PALACIO,581,B,17,166,2,4,0,0,0,0,9,198,1,7,206,
GOMEZ PALACIO,581,C,28,172,3,0,5,0,0,0,6,214,0,0,214,
GOMEZ PALACIO,582,B,23,187,6,0,0,0,0,0,3,219,0,6,225,
GOMEZ PALACIO,582,C,7,172,9,3,0,0,0,0,6,197,0,5,202,
GOMEZ PALACIO,583,B,12,151,2,3,6,0,0,0,0,174,0,4,178,
GOMEZ PALACIO,583,C,15,182,9,4,1,0,0,0,4,215,0,3,218,
GOMEZ PALACIO,584,B,23,165,5,10,0,0,0,0,0,203,0,1,204,
GOMEZ PALACIO,585,B,29,153,17,8,1,0,0,0,3,211,0,31,242,
GOMEZ PALACIO,585,C,33,153,18,11,1,0,0,1,0,217,0,23,240,
GOMEZ PALACIO,586,B,25,138,8,0,5,0,0,0,2,178,0,9,187,
GOMEZ PALACIO,587,B,31,84,9,0,0,0,0,0,6,130,0,0,130,
GOMEZ PALACIO,588,B,32,192,30,5,1,0,0,1,9,270,0,2,272,
GOMEZ PALACIO,588,X,54,198,2,1,4,0,0,0,5,264,0,7,271,
GOMEZ PALACIO,589,B,11,111,18,0,0,0,0,0,8,148,0,5,153,
GOMEZ PALACIO,589,C,7,135,22,1,0,0,0,0,6,171,0,4,175,
GOMEZ PALACIO,590,B,25,180,16,1,0,0,0,0,4,226,0,4,230,
GOMEZ PALACIO,590,C,10,181,10,2,0,0,0,0,2,205,0,3,208,
GOMEZ PALACIO,591,B,27,255,21,0,1,0,0,0,0,304,5,0,309,
GOMEZ PALACIO,592,B,5,108,28,0,0,0,0,1,3,145,0,3,148,
GOMEZ PALACIO,592,C,15,87,35,0,0,0,0,0,0,137,0,1,138,
GOMEZ PALACIO,593,B,20,94,3,0,0,0,0,0,7,124,0,3,127,
GOMEZ PALACIO,594,B,26,175,4,1,1,0,0,0,17,224,0,10,234,
GOMEZ PALACIO,595,B,23,174,1,1,0,0,0,0,7,206,0,5,211,
GOMEZ PALACIO,596,B,22,121,9,6,0,0,0,0,2,160,0,4,164,
GOMEZ PALACIO,597,B,16,151,4,1,1,0,0,0,1,174,0,7,181,
GOMEZ PALACIO,597,C,7,179,1,2,0,0,0,0,2,191,0,10,201,
GOMEZ PALACIO,597,C,5,176,6,0,0,0,0,1,3,191,0,2,193,
GOMEZ PALACIO,598,B,12,201,5,4,1,0,0,0,3,226,0,4,230,
GOMEZ PALACIO,599,B,3,12,0,0,0,0,0,0,0,15,0,0,15,
GOMEZ PALACIO,600,B,36,199,7,0,0,0,0,0,3,245,0,6,251,
GOMEZ PALACIO,600,C,41,196,7,4,1,0,0,0,2,251,0,0,251,
GOMEZ PALACIO,601,B,23,189,32,1,0,0,0,0,6,251,0,7,258,
GOMEZ PALACIO,601,C,29,204,30,1,6,0,0,1,9,280,0,5,285,
GOMEZ PALACIO,602,B,28,120,2,1,0,0,0,0,0,151,0,1,152,
GOMEZ PALACIO,603,B,63,193,6,0,2,0,0,0,2,266,0,0,266,
GOMEZ PALACIO,603,C,63,213,4,3,6,0,0,0,3,292,0,0,292,
GOMEZ PALACIO,604,B,57,197,6,1,0,0,0,0,11,272,0,0,272,
GOMEZ PALACIO,605,B,53,108,1,0,0,0,0,0,3,165,0,6,171,
GOMEZ PALACIO,605,C,38,117,2,0,0,0,0,0,8,165,0,3,168,
GOMEZ PALACIO,606,B,5,29,2,7,0,0,0,0,0,43,0,1,44,
GOMEZ PALACIO,607,B,41,118,5,0,1,0,0,0,2,167,0,0,167,
GOMEZ PALACIO,607,C,32,127,3,0,0,0,0,0,5,167,0,4,171,
GOMEZ PALACIO,608,B,24,158,16,0,4,0,0,0,13,215,0,10,225,
GOMEZ PALACIO,608,C,19,150,12,6,1,0,0,0,2,190,0,3,193,
GOMEZ PALACIO,609,B,36,168,3,1,1,0,0,0,7,216,0,2,218,
GOMEZ PALACIO,610,B,27,121,4,0,1,0,0,0,3,156,0,0,156,
GOMEZ PALACIO,611,B,46,156,3,0,0,0,0,1,0,206,0,2,208,
GOMEZ PALACIO,611,C,32,159,3,1,1,0,0,0,4,200,0,2,202,
,,,,,,,,,,,,,,,,
GUADALUPE VICTORIA,612,B,201,113,6,1,,,,0,68,389,0,225,614,
GUADALUPE VICTORIA,612,C,182,99,12,1,0,0,0,0,73,367,0,13,380,
GUADALUPE VICTORIA,613,B,130,64,12,1,0,0,0,0,67,274,0,6,280,
GUADALUPE VICTORIA,613,C,131,53,8,5,0,0,0,0,49,246,0,0,246,
GUADALUPE VICTORIA,614,B,157,158,18,6,0,0,0,0,64,403,0,4,407,
GUADALUPE VICTORIA,614,C,156,148,16,2,0,0,0,0,81,403,0,6,409,
GUADALUPE VICTORIA,615,B,196,120,8,5,0,0,0,0,42,371,0,2,373,
GUADALUPE VICTORIA,615,C,194,83,12,8,0,0,0,0,37,334,0,1,335,
GUADALUPE VICTORIA,616,B,120,101,1,4,0,0,0,0,39,265,0,0,265,
GUADALUPE VICTORIA,616,C,127,116,3,6,0,0,0,0,31,283,0,2,285,
GUADALUPE VICTORIA,617,B,158,142,11,6,0,0,0,0,139,456,0,4,460,
GUADALUPE VICTORIA,618,B,122,127,13,6,0,0,0,0,109,377,0,10,387,
GUADALUPE VICTORIA,619,B,113,93,6,7,0,0,0,0,57,276,0,2,278,
GUADALUPE VICTORIA,619,C,138,66,13,17,0,0,0,0,56,290,0,2,292,
GUADALUPE VICTORIA,620,B,96,84,2,13,0,0,0,0,51,246,0,5,251,
GUADALUPE VICTORIA,620,C,101,59,4,4,0,0,0,0,75,243,0,4,247,
GUADALUPE VICTORIA,621,B,145,72,3,4,0,0,0,0,59,283,0,2,285,
GUADALUPE VICTORIA,621,C,120,83,2,3,0,0,0,0,57,265,0,0,265,
GUADALUPE VICTORIA,622,B,82,185,3,6,0,0,0,0,77,353,0,0,353,
GUADALUPE VICTORIA,623,B,7,37,1,2,0,0,0,0,18,65,0,0,65,
GUADALUPE VICTORIA,624,B,104,46,1,7,0,0,0,0,51,209,0,7,216,
GUADALUPE VICTORIA,624,C,106,52,0,6,0,0,0,0,51,215,0,4,219,
GUADALUPE VICTORIA,625,B,145,70,1,8,0,0,0,0,33,257,0,15,272,
GUADALUPE VICTORIA,625,C,169,56,5,3,0,0,0,0,24,257,0,9,266,
GUADALUPE VICTORIA,626,B,61,74,2,7,0,0,0,0,57,201,0,9,210,
GUADALUPE VICTORIA,627,B,19,89,6,10,0,0,0,0,45,169,0,11,180,
GUADALUPE VICTORIA,628,B,130,88,5,4,0,0,0,0,59,286,0,6,292,
GUADALUPE VICTORIA,628,C,101,90,6,2,0,0,0,0,72,271,4,8,283,
GUADALUPE VICTORIA,629,B,142,85,4,1,0,0,0,0,46,278,0,6,284,
GUADALUPE VICTORIA,629,C,159,78,1,4,0,0,0,0,42,284,0,9,293,
GUADALUPE VICTORIA,630,B,66,185,3,6,0,0,0,0,115,375,0,12,387,
GUADALUPE VICTORIA,630,C,79,182,2,15,0,0,0,0,100,378,0,10,388,
GUADALUPE VICTORIA,631,B,75,55,2,50,0,0,0,0,25,207,0,11,218,
GUADALUPE VICTORIA,632,B,93,104,2,26,0,0,0,0,150,375,0,18,393,
GUADALUPE VICTORIA,633,B,123,122,4,13,0,0,0,0,103,365,0,15,380,
GUADALUPE VICTORIA,634,B,153,66,0,8,0,0,0,0,30,257,0,5,262,
GUADALUPE VICTORIA,634,C,130,52,1,12,0,0,0,0,30,225,0,6,231,
GUADALUPE VICTORIA,635,B,97,65,1,3,0,0,0,0,27,193,0,14,207,
GUADALUPE VICTORIA,635,C,103,70,3,4,0,0,0,0,40,220,0,5,225,
GUADALUPE VICTORIA,636,B,157,106,1,6,0,0,0,0,32,302,0,18,320,
GUADALUPE VICTORIA,636,C,150,109,2,15,0,0,0,0,37,313,0,7,320,
GUADALUPE VICTORIA,637,B,19,43,1,17,0,0,0,0,28,108,0,10,118,
GUADALUPE VICTORIA,637,X,14,16,0,0,0,0,0,0,5,35,0,1,36,
,,,,,,,,,,,,,,,,
GUANACEVI,638,B,127,89,0,10,0,0,0,0,1,227,0,5,232,
GUANACEVI,638,C,159,74,0,9,0,0,0,0,1,243,0,9,252,
GUANACEVI,639,B,188,100,0,11,0,0,0,0,1,300,0,9,309,
GUANACEVI,640,B,4,58,0,1,0,0,0,0,0,63,0,7,70,
GUANACEVI,641,B,23,118,0,1,0,0,0,0,2,144,1,5,150,
GUANACEVI,641,X,6,51,0,1,0,0,0,0,0,58,0,1,59,
GUANACEVI,642,B,18,51,0,1,0,0,0,0,0,70,0,2,72,
GUANACEVI,642,X,9,78,0,1,0,0,0,0,0,88,0,1,89,
GUANACEVI,643,B,32,87,0,2,0,0,0,0,0,121,0,4,125,
GUANACEVI,644,B,18,142,0,1,0,0,0,0,1,162,0,4,166,
GUANACEVI,644,X,23,44,0,0,0,0,0,0,0,67,0,4,71,
GUANACEVI,644,X,118,74,0,1,0,0,0,0,0,193,0,10,203,
GUANACEVI,645,B,127,13,0,7,0,0,0,0,0,147,0,4,151,
GUANACEVI,646,B,47,28,0,1,0,0,0,0,0,76,0,4,80,
GUANACEVI,647,B,38,17,0,3,0,0,0,0,1,59,0,2,61,
GUANACEVI,648,B,15,27,0,0,0,0,0,0,1,43,0,2,45,
GUANACEVI,649,B,24,32,0,1,0,0,0,0,0,57,0,5,62,
GUANACEVI,650,B,12,29,0,1,0,0,0,0,0,42,0,2,44,
GUANACEVI,651,B,51,40,0,3,0,0,0,0,0,94,0,6,100,
GUANACEVI,652,B,22,17,0,1,0,0,0,0,0,40,0,2,42,
GUANACEVI,653,B,96,52,0,11,0,0,0,0,1,160,0,3,163,
GUANACEVI,654,B,196,195,0,6,0,0,0,0,4,401,0,48,449,
GUANACEVI,655,B,18,131,0,0,0,0,0,0,0,149,0,5,154,
GUANACEVI,656,B,180,89,0,5,0,0,0,0,0,274,0,17,291,
GUANACEVI,657,B,29,19,0,1,0,0,0,0,1,50,0,2,52,
GUANACEVI,658,B,45,50,0,1,0,0,0,0,0,96,6,6,108,
GUANACEVI,659,B,29,106,0,0,0,0,0,0,1,136,0,3,139,
GUANACEVI,660,B,8,38,0,1,0,0,0,0,0,47,0,2,49,
GUANACEVI,661,B,81,148,0,6,0,0,0,0,2,237,0,17,254,
GUANACEVI,662,B,31,51,0,1,0,0,0,0,1,84,0,8,92,
GUANACEVI,663,B,8,62,0,14,0,0,0,0,0,84,0,4,88,
,,,,,,,,,,,,,,,,
,,,,,,,,,,,,,,,,
HIDALGO,664,B,189,170,0,0,4,0,0,0,0,363,0,4,367,
HIDALGO,665,B,31,32,0,0,0,0,0,0,0,63,0,1,64,
HIDALGO,666,B,85,69,0,0,0,0,0,0,0,154,0,2,156,
HIDALGO,667,B,141,69,0,0,0,0,0,0,0,210,0,5,215,
HIDALGO,668,B,209,191,0,0,2,0,0,0,1,403,0,10,413,
HIDALGO,668,X,82,48,0,0,0,0,0,0,0,130,0,3,133,
HIDALGO,669,B,41,29,0,1,0,0,0,0,0,71,0,1,72,
HIDALGO,670,B,127,105,0,0,0,0,0,0,1,233,0,4,237,
HIDALGO,671,B,95,53,0,0,7,0,0,0,0,155,0,6,161,
HIDALGO,671,X,47,80,0,0,0,0,0,0,0,127,0,2,129,
,,,,,,,,,,,,,,,,
INDE,672,B,122,68,0,0,0,0,0,0,0,190,0,3,193,
INDE,673,B,81,43,0,0,0,0,0,0,1,125,0,0,125,
INDE,674,B,79,60,0,0,0,0,0,0,12,151,0,3,154,
INDE,675,B,40,45,0,0,0,0,0,0,26,111,0,12,123,
INDE,676,B,32,31,0,0,0,0,0,0,3,66,0,0,66,
INDE,677,B,37,30,0,0,0,0,0,0,4,71,0,2,73,
INDE,678,B,160,85,0,0,0,0,0,0,3,248,0,4,252,
INDE,679,B,51,60,0,0,0,0,0,0,0,111,0,4,115,
INDE,680,B,33,42,0,0,0,0,0,0,0,75,0,0,75,
INDE,681,B,45,93,0,0,0,0,0,0,1,139,6,4,149,
INDE,682,B,12,40,0,0,0,0,0,0,2,54,0,3,57,
INDE,683,B,16,42,0,0,0,0,0,0,2,60,0,1,61,
INDE,683,X,39,21,0,0,0,0,0,0,1,61,0,0,61,
INDE,684,B,99,70,0,0,0,0,0,0,3,172,3,4,179,
INDE,684,X,22,23,0,0,0,0,0,0,0,45,0,0,45,
INDE,685,B,21,96,0,0,0,0,0,0,3,120,0,3,123,
INDE,686,B,65,74,0,0,0,0,0,0,4,143,0,0,143,
INDE,686,X,40,24,0,0,0,0,0,0,8,72,0,1,73,
INDE,687,B,58,86,0,0,0,0,0,0,2,146,2,2,150,
INDE,687,X,56,27,0,0,0,0,0,0,0,83,0,10,93,
INDE,688,B,34,8,0,0,0,0,0,0,2,44,0,2,46,
,,,,,,,,,,,,,,,,
LERDO,689,B,64,94,6,9,78,,,6,5,262,,4,266,
LERDO,689,C,68,89,4,10,83,0,0,10,11,275,1,4,280,
LERDO,690,B,135,138,12,1,3,0,0,2,16,307,0,6,313,
LERDO,690,C,119,128,9,0,3,0,0,2,6,267,0,4,271,
LERDO,691,B,81,90,0,1,17,0,0,1,2,192,0,7,199,
LERDO,692,B,60,64,2,1,3,0,0,1,3,134,0,1,135,
LERDO,692,C,73,94,1,1,2,0,0,1,3,175,0,1,176,
LERDO,693,B,66,91,6,3,7,0,0,6,3,182,0,3,185,
LERDO,693,C,73,83,2,1,8,0,0,5,1,173,0,0,173,
LERDO,694,B,101,118,2,1,10,0,0,1,6,239,0,3,242,
LERDO,694,C,135,88,0,0,6,0,0,2,5,236,0,0,236,
LERDO,695,B,105,154,3,1,8,0,0,2,9,282,0,3,285,
LERDO,695,C,109,166,3,1,14,0,0,1,5,299,0,4,303,
LERDO,696,B,133,154,2,0,9,0,0,2,5,305,2,4,311,
LERDO,696,C,150,156,4,0,7,0,0,4,3,324,0,9,333,
LERDO,697,B,151,185,8,2,14,0,0,5,9,374,0,2,376,
LERDO,697,C,140,186,7,2,7,0,0,9,7,358,0,3,361,
LERDO,698,B,133,137,12,1,4,0,0,8,13,308,0,3,311,
LERDO,699,B,102,98,4,2,4,0,0,3,1,214,0,3,217,
LERDO,699,C,99,108,3,3,4,0,0,4,12,233,0,3,236,
LERDO,700,B,130,106,4,1,9,0,0,7,16,273,0,1,274,
LERDO,701,B,91,131,5,2,4,0,0,1,5,239,0,6,245,
LERDO,701,C,108,114,4,0,6,0,0,1,8,241,0,5,246,
LERDO,702,B,187,154,10,2,7,0,0,4,12,376,0,9,385,
LERDO,703,B,118,109,1,6,4,0,0,2,2,242,0,4,246,
LERDO,703,C,140,104,1,2,5,0,0,1,2,255,0,2,257,
LERDO,704,B,156,130,9,1,3,0,,3,13,315,0,1,316,
LERDO,704,C,154,137,2,2,5,0,,2,5,307,0,16,323,
LERDO,705,B,138,150,4,4,5,0,,2,10,313,0,3,316,
LERDO,705,C,144,165,2,1,4,0,,4,4,324,0,2,326,
LERDO,705,C,139,173,3,0,15,0,,2,8,340,0,3,343,
LERDO,706,B,62,52,1,0,25,0,,1,8,149,0,1,150,
LERDO,706,C,52,71,1,1,13,0,,4,8,150,0,3,153,
LERDO,707,B,81,103,5,0,4,0,,2,0,195,0,3,198,
LERDO,708,B,60,83,5,2,0,0,,2,1,153,0,2,155,
LERDO,708,C,52,93,3,1,1,0,,2,1,153,0,2,155,
LERDO,709,B,99,177,5,3,10,0,,1,2,297,0,2,299,
LERDO,710,B,60,122,3,1,2,0,,0,2,190,0,7,197,
LERDO,710,C,70,149,5,8,0,0,,4,10,246,0,2,248,
LERDO,711,B,108,175,2,3,1,0,,1,4,294,0,6,300,
LERDO,711,C,113,184,2,1,9,0,,3,4,316,4,0,320,
LERDO,712,B,136,115,1,3,5,0,,1,7,268,0,0,268,
LERDO,712,C,138,128,2,7,5,0,,1,2,283,0,7,290,
LERDO,713,B,117,147,3,2,3,0,,2,1,275,0,3,278,
LERDO,713,C,143,110,0,3,6,0,,1,8,271,0,4,275,
LERDO,714,B,111,93,2,2,5,0,,1,5,219,0,1,220,
LERDO,714,C,128,109,3,0,3,0,,4,6,253,0,1,254,
LERDO,715,B,100,125,8,3,6,0,,1,4,247,0,4,251,
LERDO,715,C,121,103,1,6,3,0,,2,2,238,0,7,245,
LERDO,716,B,145,159,7,1,5,0,,1,17,335,0,6,341,
LERDO,717,B,69,138,23,4,2,0,,0,9,245,0,0,245,
LERDO,718,B,73,87,3,1,6,0,,1,2,173,0,2,175,
LERDO,718,C,99,88,1,2,11,0,,1,1,203,0,1,204,
LERDO,719,B,127,145,2,2,3,0,0,1,7,287,,12,299,
LERDO,719,C,135,138,5,2,8,0,0,1,12,301,,4,305,
LERDO,720,B,121,147,0,1,9,0,0,1,5,284,0,3,287,
LERDO,720,C,107,190,4,1,10,0,0,1,2,315,0,7,322,
LERDO,721,B,109,178,2,2,5,0,0,1,1,298,0,3,301,
LERDO,721,C,93,146,1,2,3,0,0,1,3,249,0,5,254,
LERDO,722,B,110,143,3,1,4,0,0,1,9,271,0,5,276,
LERDO,722,C,127,134,0,2,7,0,0,2,7,279,0,4,283,
LERDO,722,C,119,143,7,5,5,0,0,3,4,286,0,6,292,
LERDO,723,B,180,152,1,3,11,0,0,0,4,351,0,4,355,
LERDO,723,C,151,153,3,5,11,0,0,3,2,328,0,4,332,
LERDO,724,B,128,103,4,5,3,0,0,3,5,251,0,6,257,
LERDO,724,C,124,131,1,2,4,0,0,1,1,264,0,6,270,
LERDO,725,B,81,143,3,15,6,0,0,0,2,250,0,5,255,
LERDO,726,B,70,94,1,0,3,0,0,0,2,170,0,3,173,
LERDO,726,C,79,82,4,2,4,0,0,1,2,174,0,2,176,
LERDO,727,B,86,89,3,6,32,0,0,1,2,219,0,4,223,
LERDO,727,C,102,99,2,3,38,0,0,2,3,249,0,6,255,
LERDO,728,B,7,117,2,4,6,0,0,0,59,195,0,5,200,
LERDO,729,B,41,34,1,1,2,0,0,0,1,80,0,29,109,
LERDO,730,B,75,67,1,5,19,0,0,0,10,177,0,4,181,
LERDO,730,C,69,71,2,2,12,0,0,0,3,159,0,3,162,
LERDO,730,X,67,77,1,1,0,0,0,0,22,168,0,0,168,
LERDO,731,B,80,59,0,0,28,0,0,0,33,200,0,5,205,
LERDO,732,B,64,89,2,4,23,0,0,0,6,188,,9,197,
LERDO,733,B,89,130,1,3,25,0,0,0,2,250,0,2,252,
LERDO,733,C,92,98,3,2,22,0,0,0,2,219,0,4,223,
LERDO,734,B,55,118,8,8,4,0,0,0,1,194,0,10,204,
LERDO,734,C,58,146,2,5,3,0,0,0,0,214,0,3,217,
LERDO,735,B,109,184,7,1,19,0,0,0,1,321,0,7,328,
LERDO,735,C,123,205,6,7,28,0,0,0,2,371,0,9,380,
LERDO,736,B,19,113,6,1,21,0,0,0,5,165,0,0,165,
LERDO,737,B,34,137,16,1,50,0,0,1,5,244,0,4,248,
LERDO,737,C,44,118,9,1,43,0,0,0,5,220,0,0,220,
LERDO,738,B,61,211,23,0,2,0,0,0,19,316,0,2,318,
LERDO,738,C,71,219,29,4,4,0,0,0,12,339,0,4,343,
LERDO,739,B,59,117,6,1,0,0,0,0,0,183,0,0,183,
LERDO,739,C,49,109,9,2,2,0,0,0,0,171,0,1,172,
LERDO,739,X,33,107,7,2,0,0,0,0,3,152,0,1,153,
LERDO,740,B,38,108,20,4,7,0,0,0,1,178,0,4,182,
LERDO,741,B,38,178,8,0,10,0,0,3,3,240,0,0,240,
LERDO,741,C,44,181,4,3,7,0,0,1,2,242,0,6,248,
LERDO,742,B,25,157,3,2,15,0,0,0,1,203,0,0,203,
LERDO,742,C,42,144,6,2,13,0,0,0,5,212,0,4,216,
LERDO,743,B,72,116,3,0,0,0,0,0,3,194,0,4,198,
LERDO,744,B,59,100,1,3,1,0,0,1,14,179,0,3,182,
LERDO,745,B,81,194,4,3,1,0,0,0,3,286,0,0,286,
LERDO,746,B,82,76,6,3,3,0,0,0,5,175,0,0,175,
LERDO,746,C,78,93,1,2,0,0,0,0,0,174,0,1,175,
LERDO,747,B,47,229,0,0,3,0,0,0,7,286,0,6,292,
LERDO,747,C,54,198,2,1,0,0,0,0,2,257,0,1,258,
LERDO,748,B,53,60,26,1,11,0,0,0,9,160,0,4,164,
LERDO,748,C,72,45,17,1,0,0,0,0,16,151,0,2,153,
LERDO,749,B,54,81,6,1,23,0,0,0,2,167,0,0,167,
LERDO,749,C,73,62,8,0,38,0,0,0,0,181,0,1,182,
LERDO,750,B,63,104,7,0,0,0,0,1,13,188,0,1,189,
LERDO,751,B,89,116,6,1,3,0,0,0,13,228,0,8,236,
LERDO,752,B,66,110,22,1,4,0,0,0,8,211,0,2,213,
LERDO,753,B,55,107,2,0,2,0,0,0,4,170,0,0,170,
LERDO,753,C,41,103,6,0,1,0,0,0,1,152,0,6,158,
LERDO,754,B,66,173,43,3,9,0,0,1,2,297,0,0,297,
LERDO,754,C,75,155,50,3,7,0,0,0,1,291,0,0,291,
LERDO,755,B,42,88,46,4,1,0,0,0,3,184,0,5,189,
LERDO,755,C,41,84,32,4,1,0,0,0,2,164,0,0,164,
LERDO,756,B,68,105,11,0,10,0,0,0,17,211,0,2,213,
LERDO,756,C,45,146,6,1,8,0,0,0,11,217,0,5,222,
LERDO,757,B,30,71,9,11,56,0,0,0,22,199,0,8,207,
LERDO,757,C,32,99,19,8,38,0,0,0,31,227,0,0,227,
LERDO,758,B,30,24,2,2,23,0,0,0,2,83,0,0,83,
LERDO,758,X,60,26,2,1,22,0,0,0,0,111,0,2,113,
LERDO,759,B,63,26,2,0,1,0,0,0,1,93,0,25,118,
LERDO,760,B,75,76,26,1,7,0,0,0,1,186,0,3,189,
LERDO,760,C,106,87,20,1,2,0,0,0,1,217,3,2,222,
LERDO,761,B,158,140,6,0,5,0,0,0,5,314,0,3,317,
LERDO,761,C,198,124,6,1,1,0,0,0,1,331,0,0,331,
LERDO,762,B,120,157,5,0,2,0,0,0,5,289,0,4,293,
LERDO,763,B,81,103,9,0,1,0,0,0,0,194,0,4,198,
LERDO,763,X,35,37,1,0,0,0,0,0,25,98,0,3,101,
LERDO,763,C,62,112,8,0,2,0,0,0,0,184,0,26,210,
LERDO,764,B,46,116,3,3,5,0,0,0,0,173,0,0,173,
LERDO,764,C,39,101,3,2,7,0,0,0,1,153,0,3,156,
LERDO,765,B,47,62,1,2,1,0,0,0,9,122,0,1,123,
LERDO,766,B,5,8,2,1,0,0,0,0,16,32,0,2,34,
LERDO,767,B,141,44,9,0,5,0,0,0,5,204,0,0,204,
LERDO,768,B,38,17,0,2,6,0,0,0,2,65,0,0,65,
,,,,,,,,,,,,,,,,
MAPIMI,769,B,136,82,12,7,,,0,0,64,301,0,5,306,
MAPIMI,769,C,128,65,8,6,,,0,0,79,286,0,0,286,
MAPIMI,769,C,108,91,9,6,,,0,0,66,280,0,1,281,
MAPIMI,770,B,109,140,2,5,,,0,0,93,349,0,8,357,
MAPIMI,771,B,130,90,4,8,,,0,0,88,320,0,6,326,
MAPIMI,772,B,18,54,5,1,,,0,0,15,93,0,0,93,
MAPIMI,773,B,9,63,6,3,,,0,0,16,97,0,3,100,
MAPIMI,774,B,15,40,15,9,,,0,0,8,87,0,3,90,
MAPIMI,775,B,2,35,2,0,,,0,0,0,39,0,0,39,
MAPIMI,776,B,1,13,5,0,,,0,0,1,20,0,2,22,
MAPIMI,777,B,53,59,49,7,,,0,0,32,200,0,7,207,
MAPIMI,777,C,54,85,38,5,,,0,0,25,207,0,2,209,
MAPIMI,778,B,52,58,33,2,,,0,0,19,164,0,1,165,
MAPIMI,778,C,46,50,56,3,,,0,0,20,175,4,6,185,
MAPIMI,779,B,3,9,5,1,,,0,0,1,19,0,1,20,
MAPIMI,780,B,18,17,125,3,,,0,0,11,174,0,2,176,
MAPIMI,780,X,16,34,4,3,,,0,0,24,81,0,3,84,
MAPIMI,781,B,10,22,2,3,,,0,0,59,96,0,1,97,
MAPIMI,782,B,2,2,3,0,,,0,0,38,45,0,0,45,
MAPIMI,782,X,5,12,4,1,,,0,0,55,77,0,10,87,
MAPIMI,783,B,5,53,7,1,,,0,0,50,116,0,7,123,
MAPIMI,784,B,8,3,15,2,,,0,0,0,28,0,0,28,
MAPIMI,785,B,89,110,22,8,,,0,0,29,258,0,7,265,
MAPIMI,786,B,86,113,34,40,,,0,0,75,348,0,6,354,
MAPIMI,787,B,54,97,15,23,,,0,0,33,222,0,0,222,
MAPIMI,788,B,134,168,32,26,,,0,0,28,388,0,7,395,
MAPIMI,788,C,148,163,17,19,,,,0,34,381,0,10,391,
MAPIMI,789,B,71,91,25,5,0,0,0,0,40,232,0,4,236,
MAPIMI,789,C,82,67,24,9,0,0,0,0,55,237,0,3,240,
MAPIMI,790,B,43,106,65,6,0,0,0,0,107,327,0,7,334,
MAPIMI,791,B,64,123,38,16,0,0,0,0,45,286,0,2,288,
MAPIMI,792,B,63,121,5,14,0,0,0,0,12,215,0,9,224,
MAPIMI,792,X,13,87,0,45,0,0,0,0,58,203,0,10,213,
MAPIMI,793,B,72,84,27,7,0,0,0,0,21,211,4,3,218,
MAPIMI,794,B,21,48,1,3,0,0,0,0,25,98,0,1,99,
MAPIMI,795,B,18,46,0,0,0,0,0,0,20,84,0,0,84,
,,,,,,,,,,,,,,,,
MEZQUITAL,796,B,168,158,0,9,0,0,0,1,3,339,0,7,346,
MEZQUITAL,797,B,163,133,0,10,0,0,0,0,0,306,0,8,314,
MEZQUITAL,798,B,57,82,5,8,0,0,0,0,2,154,0,3,157,
MEZQUITAL,799,B,85,57,0,9,0,0,0,0,0,151,0,4,155,
MEZQUITAL,800,B,64,275,0,2,0,0,0,0,0,341,0,10,351,
MEZQUITAL,801,B,23,36,0,1,0,0,0,0,1,61,0,4,65,
MEZQUITAL,802,B,7,41,0,0,0,0,0,0,0,48,0,2,50,
MEZQUITAL,803,B,59,80,0,3,0,0,0,1,0,143,0,4,147,
MEZQUITAL,804,B,3,68,0,0,0,0,0,0,0,71,0,1,72,
MEZQUITAL,805,B,12,59,0,5,0,0,0,1,3,80,0,10,90,
MEZQUITAL,806,B,62,57,0,1,0,0,0,0,1,121,0,3,124,
MEZQUITAL,807,B,17,89,0,2,0,0,0,1,1,110,0,3,113,
MEZQUITAL,808,B,43,192,19,10,0,0,0,3,0,267,0,20,287,
MEZQUITAL,809,B,63,116,5,8,0,0,0,0,1,193,0,16,209,
MEZQUITAL,809,X,39,136,0,2,0,0,0,2,1,180,0,8,188,
MEZQUITAL,810,B,175,64,2,6,0,0,0,3,7,257,0,40,297,
MEZQUITAL,811,X,101,97,5,5,0,0,0,4,2,214,0,30,244,
MEZQUITAL,811,B,73,283,4,3,3,0,0,2,3,371,0,30,401,
MEZQUITAL,812,B,12,109,0,0,0,0,0,0,0,121,0,13,134,
MEZQUITAL,813,B,27,129,0,5,0,0,0,0,1,162,0,8,170,
MEZQUITAL,814,B,14,110,18,5,0,0,0,0,2,149,4,8,161,
MEZQUITAL,815,B,4,57,0,2,0,0,0,0,0,63,0,6,69,
MEZQUITAL,816,B,97,250,5,5,0,0,0,1,7,365,0,25,390,
MEZQUITAL,817,B,36,108,3,45,0,0,0,2,1,195,0,56,251,
MEZQUITAL,819,B,9,14,0,0,0,0,0,0,0,23,0,2,25,
MEZQUITAL,820,B,39,41,0,3,0,0,0,0,0,83,0,7,90,
MEZQUITAL,820,X,19,64,12,0,0,0,0,1,0,96,0,1,97,
MEZQUITAL,821,B,65,129,32,11,0,0,0,5,3,245,0,22,267,
MEZQUITAL,821,C,80,145,31,5,0,0,0,6,3,270,0,21,291,
MEZQUITAL,822,B,151,278,11,18,0,0,0,5,1,464,0,41,505,
MEZQUITAL,823,B,14,82,58,23,0,0,0,2,2,181,0,29,210,
MEZQUITAL,824,B,57,24,0,2,0,0,0,0,0,83,0,6,89,
MEZQUITAL,825,B,138,81,1,3,0,0,0,1,0,224,0,93,317,
MEZQUITAL,826,B,168,59,1,11,0,0,0,0,1,240,0,0,240,
MEZQUITAL,826,C,153,65,1,8,0,0,0,0,2,229,0,7,236,
MEZQUITAL,827,B,93,119,2,136,0,0,0,1,2,353,0,14,367,
,,,,,,,,,,,,,,,,
,,,,,,,,,,,,,,,,
NAZAS,828,B,271,119,7,11,0,0,0,2,1,411,0,6,417,
NAZAS,829,B,217,95,22,10,1,0,0,4,1,350,0,4,354,ANULADA POR EL TRIBUNAL ESTATAL ELECTORAL
NAZAS,830,B,222,71,31,4,0,0,0,2,0,330,0,0,330,
NAZAS,831,X,73,89,5,1,0,0,0,0,1,169,0,0,169,
NAZAS,831,B,158,58,16,2,0,0,0,3,0,237,0,6,243,
NAZAS,832,B,48,102,6,7,1,0,0,0,1,165,0,0,165,
NAZAS,833,B,138,164,18,13,0,0,0,0,6,339,0,7,346,
NAZAS,834,B,135,141,29,9,0,0,0,0,3,317,0,7,324,
NAZAS,835,B,62,135,17,6,2,0,0,0,11,233,3,9,245,
NAZAS,836,B,54,92,60,4,2,0,0,0,2,214,0,14,228,
NAZAS,837,B,92,152,20,2,11,0,0,1,0,278,1,4,283,
NAZAS,838,B,77,112,4,4,16,0,0,0,5,218,0,4,222,
NAZAS,839,B,52,228,23,4,0,0,0,0,1,308,0,0,308,
NAZAS,839,C,55,211,28,3,0,0,0,0,1,298,0,3,301,
NAZAS,840,B,16,102,2,39,0,0,0,1,0,160,0,5,165,
NAZAS,840,X,44,68,3,28,0,0,0,1,1,145,5,2,152,
NAZAS,841,B,69,46,6,2,0,0,0,0,0,123,0,0,123,
NAZAS,842,B,71,105,34,0,0,0,0,1,1,212,0,5,217,
NAZAS,843,B,17,35,9,3,0,0,0,0,0,64,0,2,66,
NAZAS,844,B,94,52,9,7,0,0,0,1,0,163,0,4,167,
,,,,,,,,,,,,,,,,
NOMBRE DE DIOS,845,B,36,64,7,98,0,0,0,2,7,214,,6,220,
NOMBRE DE DIOS,845,C,54,64,11,93,0,0,0,0,5,227,0,12,239,
NOMBRE DE DIOS,846,B,89,57,8,154,0,0,0,13,5,326,0,9,335,
NOMBRE DE DIOS,846,C,62,69,4,184,0,0,0,3,16,338,1,11,350,
NOMBRE DE DIOS,847,B,66,44,1,105,0,0,0,0,8,224,3,6,233,
NOMBRE DE DIOS,847,C,77,42,1,110,0,0,0,3,7,240,0,5,245,
NOMBRE DE DIOS,848,B,121,118,0,73,0,0,0,0,12,324,0,0,324,
NOMBRE DE DIOS,849,B,117,58,5,106,0,0,0,0,7,293,0,12,305,
NOMBRE DE DIOS,850,C,100,50,5,86,0,0,0,0,19,260,0,8,268,
NOMBRE DE DIOS,850,B,103,57,6,95,0,0,0,0,4,265,0,0,265,
NOMBRE DE DIOS,851,B,154,75,12,158,0,0,0,1,14,414,0,10,424,
NOMBRE DE DIOS,852,B,34,29,3,27,0,0,0,0,0,93,0,3,96,
NOMBRE DE DIOS,853,B,29,18,2,43,0,0,0,0,0,92,0,0,92,
NOMBRE DE DIOS,854,B,49,32,2,104,0,0,0,0,0,187,0,2,189,
NOMBRE DE DIOS,855,B,155,47,2,63,0,0,0,1,9,277,3,13,293,
NOMBRE DE DIOS,856,B,42,36,5,155,0,0,0,0,1,239,,19,258,
NOMBRE DE DIOS,857,B,49,90,2,154,0,0,0,4,4,303,,8,311,
NOMBRE DE DIOS,857,C,50,102,1,120,0,0,0,4,2,279,0,9,288,
NOMBRE DE DIOS,858,B,20,26,0,4,0,0,0,0,0,50,0,1,51,
NOMBRE DE DIOS,859,B,25,11,0,8,0,0,0,0,0,44,0,1,45,
NOMBRE DE DIOS,860,B,133,58,3,158,0,0,0,0,30,382,0,10,392,
NOMBRE DE DIOS,861,B,112,75,1,47,0,0,0,1,1,237,0,5,242,
NOMBRE DE DIOS,861,C,120,40,2,57,0,0,0,0,2,221,0,9,230,
NOMBRE DE DIOS,862,B,36,50,0,12,0,0,0,0,5,103,0,4,107,
NOMBRE DE DIOS,863,B,76,91,1,58,0,0,0,1,57,284,0,10,294,
NOMBRE DE DIOS,864,B,52,29,2,66,0,0,0,0,58,207,,3,210,
NOMBRE DE DIOS,865,B,78,22,1,44,0,0,0,0,1,146,,7,153,
,,,,,,,,,,,,,,,,
NUEVO IDEAL,866,B,121,127,0,4,0,,0,,0,252,0,5,257,
NUEVO IDEAL,866,C,119,136,0,5,0,0,0,0,0,260,0,5,265,
NUEVO IDEAL,867,B,143,134,0,6,0,0,0,0,0,283,1,2,286,
NUEVO IDEAL,868,B,153,130,0,12,0,0,0,0,1,296,0,4,300,
NUEVO IDEAL,868,C,159,109,0,7,0,0,0,0,0,275,0,4,279,
NUEVO IDEAL,868,C,184,155,0,5,0,0,0,0,0,344,0,0,344,
NUEVO IDEAL,869,B,197,116,0,13,0,0,0,0,1,327,0,4,331,
NUEVO IDEAL,870,B,117,91,0,14,0,0,0,0,0,222,0,5,227,
NUEVO IDEAL,870,C,109,79,0,29,0,0,0,0,0,217,0,8,225,
NUEVO IDEAL,871,B,151,111,0,11,0,0,0,0,0,273,0,1,274,
NUEVO IDEAL,872,B,101,120,0,9,0,0,0,2,0,232,0,1,233,
NUEVO IDEAL,873,B,55,65,0,1,0,0,0,1,0,122,0,2,124,
NUEVO IDEAL,874,B,113,159,0,2,0,0,0,3,0,277,0,10,287,
NUEVO IDEAL,875,B,137,132,0,4,0,0,0,0,0,273,0,6,279,
NUEVO IDEAL,876,B,60,77,0,4,0,0,0,0,0,141,0,3,144,
NUEVO IDEAL,877,B,71,102,0,2,0,0,0,0,1,176,1,5,182,
NUEVO IDEAL,878,B,42,79,0,1,0,0,0,0,1,123,0,5,128,
NUEVO IDEAL,879,B,113,154,0,6,0,0,0,1,0,274,0,5,279,
NUEVO IDEAL,880,B,142,56,0,4,0,0,0,0,0,202,0,4,206,
NUEVO IDEAL,881,B,245,136,0,10,0,0,0,0,0,391,0,9,400,
NUEVO IDEAL,882,B,142,134,0,4,0,0,0,1,1,282,0,6,288,
NUEVO IDEAL,883,B,75,25,0,0,0,0,0,0,1,101,0,2,103,
NUEVO IDEAL,884,B,94,51,0,1,0,0,0,3,0,149,0,1,150,
NUEVO IDEAL,885,B,40,91,0,1,0,0,0,0,0,132,0,1,133,
NUEVO IDEAL,886,B,122,63,0,0,0,0,0,0,0,185,0,5,190,
NUEVO IDEAL,887,B,113,79,0,3,0,0,0,0,0,195,0,2,197,
NUEVO IDEAL,888,B,89,28,2,0,0,0,0,0,0,119,0,1,120,
NUEVO IDEAL,888,C,103,50,0,2,0,0,0,0,0,155,0,0,155,
NUEVO IDEAL,889,B,104,57,0,3,0,0,0,0,0,164,0,3,167,
NUEVO IDEAL,890,B,146,107,0,6,0,0,0,1,0,260,0,4,264,
NUEVO IDEAL,891,B,148,113,0,1,0,0,0,0,0,262,0,4,266,
NUEVO IDEAL,891,C,103,129,0,4,0,0,0,0,0,236,0,5,241,
NUEVO IDEAL,892,B,17,32,0,1,0,0,0,0,0,50,0,2,52,
NUEVO IDEAL,893,B,40,40,0,2,0,0,0,0,0,82,0,5,87,
NUEVO IDEAL,894,B,106,152,0,6,0,0,0,0,0,264,0,7,271,
,,,,,,,,,,,,,,,,
OCAMPO,895,B,35,153,6,2,86,0,0,0,13,295,0,7,302,
OCAMPO,895,C,36,112,3,1,106,0,0,0,11,269,0,15,284,
OCAMPO,896,B,15,31,1,0,3,0,0,0,18,68,0,4,72,
OCAMPO,897,B,62,60,0,0,0,0,0,0,23,145,0,1,146,
OCAMPO,898,B,47,58,1,1,7,0,0,0,6,120,0,8,128,
OCAMPO,899,B,96,88,2,0,6,0,0,0,16,208,0,7,215,
OCAMPO,900,B,18,29,0,1,13,0,0,0,2,63,0,5,68,
OCAMPO,901,B,1,47,0,1,3,0,0,0,28,80,0,10,90,
OCAMPO,902,B,62,191,2,4,46,0,0,0,7,312,0,7,319,
OCAMPO,903,B,6,30,2,4,12,0,0,0,12,66,0,5,71,
OCAMPO,904,B,5,56,0,0,78,0,0,0,9,148,0,5,153,
OCAMPO,905,B,19,21,3,0,17,0,0,0,27,87,0,0,87,
OCAMPO,906,B,107,51,7,5,24,0,0,0,114,308,0,5,313,
OCAMPO,907,B,119,58,21,7,16,0,0,0,98,319,0,14,333,
OCAMPO,908,B,128,56,19,3,12,0,0,0,127,345,0,6,351,
OCAMPO,909,B,71,53,7,1,24,0,0,0,163,319,0,5,324,
OCAMPO,910,B,86,68,6,1,10,0,0,0,246,417,0,13,430,
OCAMPO,911,B,205,44,8,0,56,0,0,0,81,394,0,8,402,
OCAMPO,912,B,19,53,0,2,12,0,0,0,27,113,0,1,114,
OCAMPO,913,B,18,87,2,3,21,0,0,0,56,187,0,5,192,
,,,,,,,,,,,,,,,,
,,,,,,,,,,,,,,,,
EL ORO,914,B,81,77,9,3,,0,0,0,51,221,0,7,228,
EL ORO,915,B,130,180,14,2,0,0,0,0,78,404,0,12,416,
EL ORO,916,B,117,134,10,3,0,0,0,0,42,306,0,15,321,
EL ORO,916,C,126,136,4,1,0,0,0,0,46,313,6,6,325,
EL ORO,917,B,106,144,4,3,0,0,0,0,72,329,0,10,339,
EL ORO,917,C,110,122,4,3,0,0,0,0,76,315,0,7,322,
EL ORO,918,B,54,8,2,0,0,0,0,0,5,69,0,2,71,
EL ORO,919,B,56,46,2,2,0,0,0,0,15,121,0,2,123,
EL ORO,920,B,29,11,0,0,0,0,0,0,1,41,0,0,41,
EL ORO,921,B,40,12,1,1,0,0,0,0,2,56,0,5,61,
EL ORO,922,B,21,30,0,0,0,0,0,0,1,52,0,0,52,
EL ORO,923,B,23,35,2,3,0,0,0,0,37,100,0,2,102,
EL ORO,924,B,23,49,1,0,0,0,0,0,3,76,0,3,79,
EL ORO,925,B,13,9,0,1,0,0,0,0,2,25,0,1,26,
EL ORO,926,B,30,6,0,1,0,0,0,0,5,42,0,0,42,
EL ORO,927,B,27,12,0,0,0,0,0,0,9,48,0,3,51,
EL ORO,928,B,56,33,1,1,0,0,0,0,1,92,0,2,94,
EL ORO,929,B,8,39,1,0,0,0,0,0,2,50,0,2,52,
EL ORO,930,B,25,12,0,0,0,0,0,0,19,56,0,1,57,
EL ORO,931,B,4,2,0,0,0,0,0,0,59,65,0,2,67,
EL ORO,932,B,20,18,1,3,0,0,0,0,18,60,,6,66,
EL ORO,933,B,111,18,10,2,0,0,0,0,6,147,,5,152,
EL ORO,934,B,68,65,0,0,0,0,0,0,5,138,0,2,140,
EL ORO,935,B,12,48,0,3,0,0,0,0,74,137,0,12,149,
EL ORO,936,B,56,41,1,1,0,0,0,0,15,114,0,1,115,
EL ORO,937,B,248,57,2,3,0,0,0,0,58,368,0,0,368,
EL ORO,938,B,15,11,1,0,,,,,32,59,0,2,61,
EL ORO,939,B,32,80,1,3,0,0,0,0,60,176,0,10,186,
EL ORO,940,B,16,50,0,2,0,0,0,0,63,131,0,8,139,
EL ORO,941,B,21,26,0,0,0,0,0,0,4,51,0,0,51,
EL ORO,942,B,72,23,2,2,0,0,0,0,40,139,0,10,149,
EL ORO,943,B,71,46,0,2,0,0,0,0,21,140,4,6,150,
EL ORO,944,B,1,29,0,0,0,0,0,0,7,37,4,0,41,
EL ORO,945,B,3,71,0,0,0,0,0,0,3,77,0,3,80,
EL ORO,946,B,103,70,0,0,0,0,0,0,26,199,0,4,203,
,,,,,,,,,,,,,,,,
OTAEZ,947,B,100,259,2,0,0,0,0,0,0,361,0,5,366,
OTAEZ,948,B,98,96,1,0,0,0,0,0,0,195,0,0,195,
OTAEZ,949,B,49,40,10,0,0,0,0,0,0,99,0,0,99,
OTAEZ,950,B,56,56,0,0,0,0,0,0,0,112,0,7,119,
OTAEZ,951,B,2,44,0,0,0,0,0,0,0,46,0,0,46,
OTAEZ,951,X,21,55,0,0,0,0,0,0,0,76,0,0,76,
OTAEZ,952,B,50,36,0,0,0,0,0,0,0,86,0,5,91,
OTAEZ,953,B,29,63,0,0,0,0,0,0,0,92,0,5,97,
OTAEZ,954,B,82,100,2,0,0,0,0,0,0,184,0,1,185,
OTAEZ,955,B,80,71,0,0,0,0,0,0,0,151,0,0,151,
OTAEZ,956,B,32,53,0,0,0,0,0,0,0,85,0,0,85,
OTAEZ,957,B,17,37,0,0,0,0,0,0,0,54,0,0,54,
OTAEZ,958,B,31,22,0,0,0,0,0,0,0,53,0,0,53,
OTAEZ,959,B,32,63,1,0,0,0,0,0,0,96,0,2,98,
OTAEZ,959,X,10,39,0,0,0,0,0,0,0,49,0,0,49,
OTAEZ,960,B,40,15,0,0,0,0,0,0,0,55,0,0,55,
,,,,,,,,,,,,,,,,
PANUCO DE CORONADO,961,B,76,99,5,28,0,0,0,0,30,238,0,2,240,
PANUCO DE CORONADO,961,C,49,107,12,31,0,0,0,0,34,233,1,5,239,
PANUCO DE CORONADO,962,B,165,135,12,56,0,0,0,0,47,415,0,18,433,
PANUCO DE CORONADO,963,B,69,112,9,23,0,0,0,0,47,260,0,5,265,
PANUCO DE CORONADO,963,C,48,136,12,24,0,0,0,0,56,276,0,1,277,
PANUCO DE CORONADO,964,B,21,108,20,43,0,0,0,0,84,276,0,8,284,
PANUCO DE CORONADO,964,X .,3,25,3,9,0,0,0,0,28,68,0,0,68,
PANUCO DE CORONADO,965,B,33,77,5,63,0,0,0,0,91,269,0,3,272,
PANUCO DE CORONADO,965,X,9,16,1,7,0,0,0,0,14,47,0,1,48,
PANUCO DE CORONADO,966,B,56,78,2,5,0,0,0,0,6,147,0,3,150,
PANUCO DE CORONADO,967,C,56,144,2,6,0,0,0,0,3,211,0,3,214,
PANUCO DE CORONADO,967,B,66,131,0,8,0,0,0,0,2,207,0,7,214,
PANUCO DE CORONADO,968,B,17,109,2,45,0,0,0,0,45,218,0,6,224,
PANUCO DE CORONADO,968,X,10,36,2,6,0,0,0,0,2,56,4,1,61,
PANUCO DE CORONADO,969,B,71,99,2,41,0,0,0,0,34,247,0,12,259,
PANUCO DE CORONADO,970,B,44,40,1,8,0,0,0,0,24,117,0,11,128,
PANUCO DE CORONADO,971,B,142,140,3,45,0,0,0,0,23,353,0,4,357,
PANUCO DE CORONADO,972,B,42,82,1,6,0,0,0,0,55,186,0,1,187,
PANUCO DE CORONADO,972,C,47,76,3,14,0,0,0,0,53,193,0,7,200,
PANUCO DE CORONADO,973,B,57,105,5,34,0,0,0,0,14,215,0,13,228,
PANUCO DE CORONADO,974,B,4,88,2,25,0,0,0,0,36,155,0,21,176,
PANUCO DE CORONADO,975,B,4,89,2,34,0,0,0,0,37,166,0,0,166,
PANUCO DE CORONADO,976,B,0,44,1,25,0,0,0,0,31,101,0,1,102,
,,,,,,,,,,,,,,,,
,,,,,,,,,,,,,,,,
PENON BLANCO,977,B,102,159,242,1,0,0,0,0,8,512,0,0,512,
PENON BLANCO,978,B,90,104,197,3,0,0,0,0,14,408,0,2,410,
PENON BLANCO,979,B,72,159,196,2,0,0,0,0,11,440,0,8,448,
PENON BLANCO,980,B,18,197,173,1,0,0,0,0,3,392,0,8,400,
PENON BLANCO,980,C,30,170,190,3,0,0,0,0,7,400,0,4,404,
PENON BLANCO,981,B,21,36,12,1,0,0,0,0,16,86,0,0,86,
PENON BLANCO,982,B,12,28,28,3,0,0,0,0,9,80,0,6,86,
PENON BLANCO,983,B,7,58,103,7,0,0,0,0,19,194,4,1,199,
PENON BLANCO,985,B,6,88,125,2,0,0,0,0,20,241,0,0,241,
PENON BLANCO,986,B,28,98,117,1,0,0,0,0,7,251,0,7,258,
PENON BLANCO,987,B,4,18,39,1,0,0,0,0,15,77,0,5,82,
PENON BLANCO,988,B,5,14,61,1,0,0,0,0,1,82,0,3,85,
PENON BLANCO,989,B,11,82,23,7,0,0,0,0,179,302,0,13,315,
PENON BLANCO,990,B,20,84,62,11,0,0,0,0,159,336,0,9,345,
PENON BLANCO,991,B,102,82,35,3,0,0,0,0,48,270,0,7,277,
,,,,,,,,,,,,,,,,
,,,,,,,,,,,,,,,,
POANAS,992,B,120,55,9,81,0,0,0,0,2,267,0,5,272,
POANAS,992,C,104,67,21,62,0,0,0,1,1,256,0,5,261,
POANAS,993,B,144,143,25,147,0,0,0,0,4,463,0,13,476,
POANAS,993,C,185,156,27,118,0,0,0,0,8,494,0,7,501,
POANAS,994,B,121,102,47,108,0,0,0,1,16,395,0,7,402,
POANAS,994,C,121,96,42,88,0,0,0,1,20,368,0,14,382,
POANAS,995,B,120,90,25,98,0,0,3,0,0,336,0,8,344,
POANAS,995,C,163,82,28,80,0,0,0,0,0,353,0,6,359,
POANAS,995,C,147,72,23,73,0,0,0,1,1,317,0,2,319,
POANAS,996,B,91,109,22,74,0,0,0,0,0,296,0,5,301,
POANAS,996,C,100,104,23,75,0,0,0,0,2,304,0,4,308,
POANAS,997,B,141,68,45,121,0,0,0,0,2,377,4,5,386,
POANAS,998,B,5,117,7,80,0,0,0,0,0,209,0,1,210,
POANAS,999,B,34,101,12,103,0,0,0,0,0,250,0,5,255,
POANAS,1000,B,61,52,22,110,0,0,0,0,2,247,0,7,254,
POANAS,1000,C,33,75,20,117,0,0,0,0,1,246,0,6,252,
POANAS,1001,B,68,135,42,97,0,0,0,0,2,344,0,9,353,
POANAS,1002,B,64,75,41,86,0,0,0,1,1,268,0,9,277,
POANAS,1003,B,15,76,11,344,0,0,0,0,0,446,0,3,449,
POANAS,1004,B,37,106,14,192,0,0,0,0,2,351,0,9,360,
POANAS,1005,B,34,54,7,99,0,0,0,0,1,195,0,7,202,
POANAS,1005,C,25,48,12,114,0,0,0,0,0,199,0,3,202,
POANAS,1006,B,29,95,16,170,0,0,0,5,1,316,0,0,316,
POANAS,1007,B,19,57,94,78,0,0,0,1,0,249,0,5,254,
POANAS,1008,B,43,134,58,61,0,0,0,0,3,299,0,3,302,
POANAS,1009,B,46,95,30,108,0,0,0,0,1,280,0,3,283,
POANAS,1010,B,49,59,45,110,0,0,0,0,2,265,0,5,270,
POANAS,1010,C,38,86,39,92,0,0,0,0,0,255,0,0,255,
POANAS,1011,B,61,10,21,20,0,0,0,0,1,113,0,0,113,
POANAS,1012,B,68,52,14,73,0,0,0,0,0,207,0,4,211,
POANAS,1013,B,90,33,138,45,0,0,0,0,6,312,0,7,319,
POANAS,1014,B,53,37,63,35,0,0,0,0,7,195,0,3,198,
POANAS,1014,C,52,10,57,40,0,0,0,1,2,162,0,0,162,
,,,,,,,,,,,,,,,,
PUEBLO NUEVO,1015,B,80,110,0,13,7,0,0,0,0,210,0,2,212,
PUEBLO NUEVO,1015,C,72,111,3,19,8,0,0,0,0,213,0,4,217,
PUEBLO NUEVO,1016,B,40,86,1,16,5,0,0,0,0,148,0,5,153,
PUEBLO NUEVO,1016,C,60,101,2,19,4,0,0,0,0,186,0,3,189,
PUEBLO NUEVO,1017,B,104,149,1,19,1,0,0,0,0,274,0,0,274,
PUEBLO NUEVO,1017,C,94,154,1,15,7,0,0,0,1,272,0,5,277,
PUEBLO NUEVO,1018,B,170,175,3,7,12,0,0,0,2,369,0,0,369,
PUEBLO NUEVO,1018,C,170,153,1,16,8,0,0,0,1,349,2,0,351,
PUEBLO NUEVO,1019,B,114,150,0,28,5,0,0,0,0,297,0,5,302,
PUEBLO NUEVO,1019,C,113,136,1,16,8,0,0,0,1,275,0,9,284,
PUEBLO NUEVO,1019,C,113,144,1,23,5,0,0,0,0,286,0,0,286,
PUEBLO NUEVO,1020,B,102,101,2,8,17,0,0,0,0,230,0,0,230,
PUEBLO NUEVO,1020,C,84,100,3,5,25,0,0,0,0,217,0,1,218,
PUEBLO NUEVO,1021,B,148,202,0,27,13,0,0,0,1,391,0,4,395,
PUEBLO NUEVO,1022,B,113,122,2,3,3,0,0,0,3,246,0,4,250,
PUEBLO NUEVO,1022,C,125,118,1,8,4,0,0,0,1,257,3,5,265,
PUEBLO NUEVO,1023,B,125,186,2,18,8,0,0,0,1,340,0,5,345,
PUEBLO NUEVO,1023,C,139,167,2,30,10,0,0,0,0,348,0,6,354,
PUEBLO NUEVO,1024,B,103,170,0,33,10,0,0,0,0,316,0,4,320,
PUEBLO NUEVO,1024,C,106,166,0,23,8,0,0,0,0,303,0,8,311,
PUEBLO NUEVO,1025,B,6,152,0,6,2,0,0,0,0,166,0,8,174,
PUEBLO NUEVO,1026,B,13,64,0,2,0,0,0,0,0,79,0,1,80,
PUEBLO NUEVO,1027,B,94,152,0,5,0,0,0,0,0,251,0,5,256,
PUEBLO NUEVO,1028,B,48,131,0,13,1,0,0,0,0,193,0,2,195,
PUEBLO NUEVO,1029,B,39,164,0,47,0,0,0,0,0,250,0,7,257,
PUEBLO NUEVO,1030,B,64,163,0,30,0,0,0,0,0,257,0,6,263,
PUEBLO NUEVO,1031,B,109,47,0,1,0,0,0,0,0,157,0,0,157,
PUEBLO NUEVO,1032,B,119,65,0,3,2,0,0,0,0,189,0,2,191,
PUEBLO NUEVO,1033,B,135,53,0,3,0,0,0,0,0,191,0,7,198,
PUEBLO NUEVO,1034,B,209,96,1,2,0,0,0,0,0,308,0,0,308,
PUEBLO NUEVO,1035,B,102,34,0,3,0,0,0,0,0,139,0,2,141,
PUEBLO NUEVO,1036,B,21,54,0,3,1,0,0,0,0,79,0,0,79,
PUEBLO NUEVO,1037,B,137,198,0,9,1,0,0,0,0,345,0,4,349,
PUEBLO NUEVO,1038,B,60,74,0,12,0,0,0,0,0,146,0,0,146,
PUEBLO NUEVO,1039,B,61,55,0,23,5,0,0,0,0,144,0,3,147,
PUEBLO NUEVO,1040,B,176,108,0,54,10,0,0,0,1,349,0,20,369,
PUEBLO NUEVO,1041,B,17,56,0,1,0,0,0,0,1,75,0,4,79,
PUEBLO NUEVO,1042,B,57,83,0,0,0,0,0,0,3,143,0,3,146,
PUEBLO NUEVO,1043,B,44,109,0,65,0,0,0,0,0,218,0,0,218,
PUEBLO NUEVO,1044,B,79,30,0,80,1,0,0,0,1,191,0,0,191,
PUEBLO NUEVO,1045,B,86,58,0,38,0,0,0,0,0,182,0,1,183,
PUEBLO NUEVO,1046,B,173,159,0,52,2,0,0,0,1,387,0,8,395,
PUEBLO NUEVO,1047,B,35,177,0,31,2,0,0,0,2,247,0,0,247,
PUEBLO NUEVO,1048,B,23,87,1,11,1,0,0,0,1,124,0,0,124,
PUEBLO NUEVO,1049,B,78,105,0,10,2,0,0,0,0,195,0,7,202,
PUEBLO NUEVO,1050,B,102,88,2,38,1,0,0,0,1,232,0,0,232,
PUEBLO NUEVO,1051,B,27,64,1,0,0,0,0,0,0,92,0,0,92,
PUEBLO NUEVO,1052,B,6,13,0,3,0,0,0,0,0,22,0,1,23,
PUEBLO NUEVO,1053,B,15,55,0,4,0,0,0,0,0,74,0,7,81,
PUEBLO NUEVO,1054,B,36,49,1,13,1,0,0,0,1,101,0,1,102,
PUEBLO NUEVO,1055,B,41,95,1,24,0,0,0,0,0,161,0,2,163,
PUEBLO NUEVO,1056,B,5,11,0,10,0,0,0,0,0,26,0,1,27,
PUEBLO NUEVO,1057,B,27,4,0,0,0,0,0,0,0,31,1,,32,
PUEBLO NUEVO,1058,B,7,18,1,41,0,0,0,0,0,67,0,0,67,
PUEBLO NUEVO,1059,B,6,17,0,0,0,0,0,0,1,24,0,1,25,
PUEBLO NUEVO,1060,B,23,29,0,4,0,0,0,0,1,57,0,0,57,
PUEBLO NUEVO,1061,B,16,67,2,12,3,0,0,0,1,101,0,27,128,
PUEBLO NUEVO,1062,B,7,20,0,0,0,0,0,0,0,27,0,0,27,
,,,,,,,,,,,,,,,,
,,,,,,,,,,,,,,,,
RODEO,1063,B,150,83,38,4,0,0,0,0,5,280,0,6,286,
RODEO,1063,C,142,93,35,2,0,0,0,0,1,273,0,2,275,
RODEO,1064,B,115,87,24,1,0,0,0,0,3,230,0,4,234,
RODEO,1064,C,117,81,40,1,0,0,0,0,3,242,1,1,244,
RODEO,1065,B,185,167,56,6,0,0,0,4,5,423,0,9,432,
RODEO,1066,B,59,31,27,1,0,0,0,0,2,120,0,1,121,
RODEO,1067,B,50,29,12,0,0,0,0,0,2,93,0,0,93,
RODEO,1068,B,80,68,118,3,0,0,0,0,4,273,0,12,285,
RODEO,1068,C,75,78,103,4,0,0,0,0,2,262,0,12,274,
RODEO,1069,B,63,32,25,1,0,0,0,0,4,125,0,3,128,
RODEO,1070,B,52,43,27,2,0,0,0,0,2,126,0,3,129,
RODEO,1070,X,17,31,17,2,0,0,0,1,3,71,0,1,72,
RODEO,1071,B,127,59,18,1,0,0,0,0,2,207,2,1,210,
RODEO,1072,B,24,22,9,2,0,0,0,0,0,57,0,0,57,
RODEO,1073,B,8,33,4,0,0,0,0,0,1,46,0,1,47,
RODEO,1074,B,32,15,17,1,0,0,0,0,3,68,0,0,68,
RODEO,1075,B,43,65,12,0,0,0,0,0,1,121,0,2,123,
RODEO,1076,B,5,21,4,1,0,0,0,0,6,37,0,0,37,
RODEO,1077,B,19,81,17,2,0,0,0,1,0,120,0,1,121,
RODEO,1078,B,23,39,44,1,0,0,0,0,11,118,0,2,120,
RODEO,1079,B,18,67,58,2,0,0,0,0,7,152,0,2,154,
RODEO,1080,B,108,54,40,5,0,0,0,1,48,256,0,3,259,
RODEO,1081,B,71,106,14,1,0,0,0,0,5,197,0,5,202,
RODEO,1082,B,50,64,56,7,0,0,0,7,8,192,0,7,199,
RODEO,1083,B,107,68,118,7,0,0,0,0,7,307,0,6,313,
RODEO,1084,B,24,59,5,1,0,0,0,0,0,89,0,0,89,
RODEO,1085,B,2,35,3,0,0,0,0,0,0,40,0,0,40,
,,,,,,,,,,,,,,,,
SAN BERNARDO,1086,B,124,247,0,0,0,0,0,0,0,371,0,10,381,
SAN BERNARDO,1087,B,8,108,0,0,0,0,0,0,0,116,0,1,117,
SAN BERNARDO,1088,B,6,126,0,0,0,0,0,0,0,132,0,2,134,
SAN BERNARDO,1089,B,11,133,0,0,0,0,0,0,0,144,0,3,147,
SAN BERNARDO,1090,B,3,68,0,0,0,0,0,0,0,71,0,5,76,
SAN BERNARDO,1091,B,14,42,0,0,0,0,0,0,0,56,0,1,57,
SAN BERNARDO,1092,B,37,53,0,0,0,0,0,0,0,90,2,2,94,
SAN BERNARDO,1092,X,7,87,0,0,0,0,0,0,0,94,0,0,94,
SAN BERNARDO,1093,B,29,59,0,0,0,0,0,0,0,88,0,7,95,
SAN BERNARDO,1094,B,32,108,0,0,0,0,0,0,0,140,0,3,143,
SAN BERNARDO,1095,B,6,44,0,0,0,0,0,0,0,50,0,1,51,
SAN BERNARDO,1095,X,4,66,0,0,0,0,0,0,0,70,0,1,71,
SAN BERNARDO,1096,B,20,153,0,0,0,0,0,0,0,173,0,6,179,
SAN BERNARDO,1097,B,9,135,0,0,0,0,0,0,0,144,0,2,146,
,,,,,,,,,,,,,,,,
SAN DIMAS,1098,B,97,261,,34,0,0,,0,1,393,0,9,402,
SAN DIMAS,1099,B,72,110,0,30,0,0,0,0,0,212,0,9,221,
SAN DIMAS,1099,C,79,105,0,38,0,0,0,2,0,224,0,7,231,
SAN DIMAS,1100,B,89,242,0,45,0,0,0,0,2,378,0,1,379,
SAN DIMAS,1101,B,27,6,0,0,0,0,0,0,0,33,0,0,33,
SAN DIMAS,1102,B,12,63,0,9,0,0,0,2,0,86,0,6,92,
SAN DIMAS,1103,B,9,34,0,35,0,0,0,0,1,79,0,10,89,
SAN DIMAS,1104,B,27,90,0,8,0,0,0,0,1,126,0,4,130,
SAN DIMAS,1105,B,21,13,0,0,0,0,0,2,0,36,0,1,37,
SAN DIMAS,1106,B,18,42,0,8,0,0,0,3,1,72,0,3,75,
SAN DIMAS,1107,B,101,37,0,12,0,0,0,2,1,153,0,0,153,
SAN DIMAS,1108,B,92,132,0,2,0,0,0,8,0,234,0,0,234,
SAN DIMAS,1109,B,65,98,0,9,0,0,0,3,0,175,0,4,179,
SAN DIMAS,1110,B,66,107,0,6,0,0,0,1,1,181,0,0,181,
SAN DIMAS,1111,B,24,23,0,1,0,0,0,0,0,48,0,0,48,
SAN DIMAS,1112,B,134,100,0,100,0,0,0,1,2,337,0,13,350,
SAN DIMAS,1113,B,6,27,0,4,0,0,0,0,7,44,0,8,52,
SAN DIMAS,1114,B,28,66,0,17,0,0,0,1,5,117,0,0,117,
SAN DIMAS,1115,B,19,50,0,16,0,0,0,0,0,85,,5,90,
SAN DIMAS,1116,B,40,134,0,10,0,0,0,0,13,197,0,7,204,
SAN DIMAS,1117,B,53,26,0,62,0,0,0,1,0,142,0,0,142,
SAN DIMAS,1118,B,42,51,0,0,0,0,0,7,2,102,0,0,102,
SAN DIMAS,1119,B,33,16,0,4,0,0,0,1,1,55,0,0,55,
SAN DIMAS,1120,B,29,57,0,3,0,0,0,0,0,89,0,0,89,
SAN DIMAS,1121,B,28,36,0,19,0,0,0,0,1,84,0,2,86,
SAN DIMAS,1122,B,101,84,0,4,0,0,0,2,3,194,0,5,199,
SAN DIMAS,1123,B,7,23,0,4,0,,,0,0,34,0,1,35,
SAN DIMAS,1125,B,34,25,0,24,0,0,0,0,0,83,0,2,85,
SAN DIMAS,1126,B,34,75,0,3,0,0,0,1,14,127,0,6,133,
SAN DIMAS,1127,B,65,111,0,15,0,0,0,0,1,192,0,7,199,
SAN DIMAS,1128,B,28,73,0,1,0,0,0,1,1,104,0,2,106,
SAN DIMAS,1129,B,9,45,0,29,0,0,0,0,1,84,0,3,87,
SAN DIMAS,1130,B,8,68,0,15,0,0,0,1,0,92,0,1,93,
SAN DIMAS,1131,B,11,169,0,12,0,0,0,0,1,193,0,6,199,
SAN DIMAS,1132,B,4,91,0,16,0,0,0,0,0,111,0,4,115,
SAN DIMAS,1133,B,2,13,0,2,0,0,0,2,0,19,0,1,20,
SAN DIMAS,1134,B,25,80,0,7,0,0,0,0,1,113,0,15,128,
SAN DIMAS,1135,B,13,58,0,3,0,0,0,0,0,74,0,7,81,
SAN DIMAS,1136,B,3,82,0,2,0,0,0,0,0,87,0,0,87,
SAN DIMAS,1137,B,3,93,0,14,0,0,0,0,1,111,0,1,112,
SAN DIMAS,1138,B,20,59,0,3,0,0,0,2,4,88,0,7,95,
SAN DIMAS,1139,B,18,41,0,12,0,0,0,1,0,72,0,0,72,
,,,,,,,,,,,,,,,,
SAN JUAN DE GUADALUPE,1140,B,142,150,0,0,0,0,0,0,0,292,0,6,298,
SAN JUAN DE GUADALUPE,1141,B,243,133,1,0,0,0,0,0,0,377,0,11,388,
SAN JUAN DE GUADALUPE,1142,B,19,37,0,0,0,0,0,0,1,57,0,0,57,
SAN JUAN DE GUADALUPE,1143,B,65,41,0,0,0,0,0,0,0,106,0,0,106,
SAN JUAN DE GUADALUPE,1144,B,20,87,0,0,0,0,0,0,1,108,0,0,108,
SAN JUAN DE GUADALUPE,1145,B,30,61,0,0,0,0,0,0,0,91,0,6,97,
SAN JUAN DE GUADALUPE,1146,B,27,24,0,0,0,0,0,0,0,51,0,0,51,
SAN JUAN DE GUADALUPE,1147,B,84,137,1,0,0,0,0,0,1,223,0,6,229,
SAN JUAN DE GUADALUPE,1148,B,60,80,0,0,0,0,0,0,0,140,0,7,147,
SAN JUAN DE GUADALUPE,1149,B,32,49,0,0,0,0,0,0,0,81,0,0,81,
SAN JUAN DE GUADALUPE,1150,B,112,26,0,0,0,0,0,0,0,138,0,7,145,
SAN JUAN DE GUADALUPE,1151,B,173,116,0,0,0,0,0,0,1,290,0,15,305,
SAN JUAN DE GUADALUPE,1152,B,88,51,0,0,0,0,0,0,1,140,0,0,140,
SAN JUAN DE GUADALUPE,1154,B,62,26,0,0,0,0,0,0,0,88,0,5,93,
SAN JUAN DE GUADALUPE,1155,B,11,38,0,0,0,0,0,0,0,49,0,2,51,
,,,,,,,,,,,,,,,,
SAN JUAN DEL RIO,1156,B,55,70,0,14,0,0,0,0,87,226,0,5,231,
SAN JUAN DEL RIO,1156,C,70,68,0,14,0,0,0,0,84,236,0,6,242,
SAN JUAN DEL RIO,1157,B,127,143,0,30,0,0,0,0,124,424,0,10,434,
SAN JUAN DEL RIO,1158,B,101,130,0,21,0,0,0,0,70,322,0,4,326,
SAN JUAN DEL RIO,1159,B,3,38,0,3,0,0,0,0,52,96,5,2,103,
SAN JUAN DEL RIO,1160,B,78,118,0,13,0,0,0,0,49,258,0,17,275,
SAN JUAN DEL RIO,1161,B,24,97,0,27,0,0,0,0,34,182,0,5,187,
SAN JUAN DEL RIO,1162,B,19,80,0,29,0,0,0,0,22,150,0,10,160,
SAN JUAN DEL RIO,1163,B,25,57,0,5,0,0,0,0,64,151,0,6,157,
SAN JUAN DEL RIO,1164,B,10,21,0,3,0,0,0,0,54,88,0,0,88,
SAN JUAN DEL RIO,1165,B,29,29,0,11,0,0,0,0,43,112,0,1,113,
SAN JUAN DEL RIO,1166,B,17,84,0,2,0,0,0,0,21,124,0,6,130,
SAN JUAN DEL RIO,1167,B,43,88,0,6,0,0,0,0,121,258,0,8,266,
SAN JUAN DEL RIO,1168,B,14,66,0,4,0,0,0,0,68,152,0,1,153,
SAN JUAN DEL RIO,1169,B,91,115,0,2,0,0,0,0,116,324,0,5,329,
SAN JUAN DEL RIO,1169,X,9,60,0,5,0,0,0,0,27,101,0,1,102,
SAN JUAN DEL RIO,1170,B,16,40,0,4,0,0,0,0,18,78,0,1,79,
SAN JUAN DEL RIO,1171,B,89,48,0,71,0,0,0,0,96,304,0,11,315,
SAN JUAN DEL RIO,1172,B,80,85,0,44,0,0,0,0,49,258,0,4,262,
SAN JUAN DEL RIO,1173,B,22,48,0,9,0,0,0,0,124,203,0,0,203,
SAN JUAN DEL RIO,1174,B,30,86,0,25,0,0,0,0,29,170,0,0,170,
SAN JUAN DEL RIO,1175,B,7,59,0,1,0,0,0,0,25,92,0,8,100,
SAN JUAN DEL RIO,1176,B,6,67,0,4,0,0,0,0,19,96,0,3,99,
SAN JUAN DEL RIO,1177,B,4,48,0,3,0,0,0,0,28,83,0,2,85,
SAN JUAN DEL RIO,1178,B,2,18,0,0,0,0,0,0,34,54,0,0,54,
,,,,,,,,,,,,,,,,
SAN LUIS DEL CORDERO,1179,B,83,115,0,5,0,0,0,0,4,207,0,5,212,
SAN LUIS DEL CORDERO,1180,B,123,127,0,2,0,0,0,0,0,252,0,5,257,
SAN LUIS DEL CORDERO,1181,B,129,95,0,1,0,0,0,0,0,225,0,3,228,
SAN LUIS DEL CORDERO,1182,B,8,82,0,0,0,0,0,0,0,90,0,0,90,
SAN LUIS DEL CORDERO,1182,X,35,97,3,0,0,0,0,0,1,136,0,4,140,
,,,,,,,,,,,,,,,,
SAN PEDRO DEL GALLO,1183,B,131,174,0,0,0,0,0,0,7,312,0,6,318,
SAN PEDRO DEL GALLO,1184,B,70,45,0,0,0,0,0,0,2,117,0,4,121,
SAN PEDRO DEL GALLO,1185,B,6,48,0,0,0,0,0,0,0,54,0,0,54,
SAN PEDRO DEL GALLO,1186,B,24,21,0,0,0,0,0,0,2,47,0,0,47,
SAN PEDRO DEL GALLO,1187,B,28,60,0,0,0,0,0,0,1,89,0,1,90,
SAN PEDRO DEL GALLO,1188,B,30,29,0,0,0,0,0,0,1,60,0,3,63,
SAN PEDRO DEL GALLO,1189,B,15,27,0,0,0,0,0,0,0,42,0,0,42,
SAN PEDRO DEL GALLO,1190,B,17,64,0,0,0,0,0,0,1,82,0,1,83,
,,,,,,,,,,,,,,,,
SANTA CLARA,1191,B,23,145,102,15,0,0,0,0,14,299,0,4,303,
SANTA CLARA,1192,B,49,141,95,30,0,0,0,0,19,334,0,3,337,
SANTA CLARA,1192,C,53,164,108,14,0,0,0,0,9,348,0,3,351,
SANTA CLARA,1193,B,28,176,177,22,0,0,0,0,15,418,0,0,418,
SANTA CLARA,1194,B,23,125,107,11,0,0,0,0,9,275,0,2,277,
SANTA CLARA,1195,B,38,79,26,3,0,0,0,0,0,146,0,3,149,
SANTA CLARA,1196,B,3,31,9,4,0,0,0,0,0,47,0,1,48,
SANTA CLARA,1197,B,36,118,96,7,0,0,0,0,2,259,0,6,265,
SANTA CLARA,1197,X,9,52,17,19,0,0,0,0,0,97,0,1,98,
SANTA CLARA,1198,B,17,164,78,0,0,0,0,0,7,266,0,0,266,
SANTA CLARA,1199,B,17,184,140,35,0,0,0,0,18,394,0,12,406,
,,,,,,,,,,,,,,,,
SANTIAGO PAPASQUIARO,1200,B,191,291,1,6,0,0,0,0,0,489,0,3,492,
SANTIAGO PAPASQUIARO,1201,B,179,161,1,3,0,0,0,0,0,344,0,9,353,
SANTIAGO PAPASQUIARO,1201,C,197,146,1,5,0,0,0,0,0,349,1,4,354,
SANTIAGO PAPASQUIARO,1202,B,94,144,3,14,2,0,0,0,0,257,0,3,260,
SANTIAGO PAPASQUIARO,1202,C,96,158,1,12,0,0,0,0,0,267,0,3,270,
SANTIAGO PAPASQUIARO,1203,B,101,108,2,7,1,0,0,0,1,220,0,7,227,
SANTIAGO PAPASQUIARO,1203,C,108,118,0,3,0,0,0,0,1,230,0,4,234,
SANTIAGO PAPASQUIARO,1204,B,108,188,1,0,0,0,0,0,1,298,5,0,303,
SANTIAGO PAPASQUIARO,1204,C,110,177,2,2,0,0,0,0,0,291,1,4,296,
SANTIAGO PAPASQUIARO,1205,B,145,166,0,8,1,0,0,0,1,321,0,1,322,
SANTIAGO PAPASQUIARO,1205,C,147,180,0,6,1,0,0,0,1,335,0,1,336,
SANTIAGO PAPASQUIARO,1206,B,154,171,7,3,1,0,0,0,0,336,0,5,341,
SANTIAGO PAPASQUIARO,1207,B,94,128,1,5,0,0,0,0,0,228,0,8,236,
SANTIAGO PAPASQUIARO,1207,C,104,126,0,2,0,0,0,0,0,232,0,3,235,
SANTIAGO PAPASQUIARO,1208,B,146,132,2,1,0,0,0,0,0,281,0,3,284,
SANTIAGO PAPASQUIARO,1208,C,141,109,0,4,1,0,0,0,0,255,0,4,259,
SANTIAGO PAPASQUIARO,1209,B,140,204,2,5,0,0,0,0,0,351,,4,355,
SANTIAGO PAPASQUIARO,1210,B,160,179,0,7,0,0,0,0,0,346,0,3,349,
SANTIAGO PAPASQUIARO,1211,B,176,179,0,6,0,0,0,0,0,361,0,3,364,
SANTIAGO PAPASQUIARO,1212,B,191,170,1,6,0,0,0,0,0,368,0,8,376,
SANTIAGO PAPASQUIARO,1212,C,156,208,3,6,2,0,0,0,0,375,0,4,379,
SANTIAGO PAPASQUIARO,1213,B,145,152,0,7,0,0,0,0,0,304,3,5,312,
SANTIAGO PAPASQUIARO,1213,C,113,155,1,3,1,0,0,0,0,273,0,4,277,
SANTIAGO PAPASQUIARO,1214,B,129,165,1,7,1,0,0,0,1,304,0,5,309,
SANTIAGO PAPASQUIARO,1215,B,75,40,0,1,0,0,0,0,0,116,0,1,117,
SANTIAGO PAPASQUIARO,1216,B,6,6,0,0,0,0,0,0,0,12,0,0,12,
SANTIAGO PAPASQUIARO,1217,B,47,43,0,0,0,0,0,0,0,90,0,0,90,
SANTIAGO PAPASQUIARO,1218,B,37,27,0,1,0,0,0,0,0,65,0,6,71,
SANTIAGO PAPASQUIARO,1219,B,151,202,0,3,0,0,0,0,0,356,8,0,364,
SANTIAGO PAPASQUIARO,1220,B,78,84,1,4,1,0,0,0,0,168,0,42,210,
SANTIAGO PAPASQUIARO,1221,B,38,23,1,2,0,0,0,0,0,64,0,0,64,
SANTIAGO PAPASQUIARO,1222,B,73,174,0,1,0,0,0,0,0,248,0,8,256,
SANTIAGO PAPASQUIARO,1223,B,11,29,0,1,0,0,0,0,0,41,1,42,84,
SANTIAGO PAPASQUIARO,1224,B,59,69,0,4,0,0,0,0,0,132,0,2,134,
SANTIAGO PAPASQUIARO,1224,X,51,51,0,2,0,0,0,0,0,104,0,2,106,
SANTIAGO PAPASQUIARO,1225,B,84,30,0,0,0,0,0,0,0,114,0,3,117,
SANTIAGO PAPASQUIARO,1226,B,30,51,0,0,0,0,0,0,0,81,0,0,81,
SANTIAGO PAPASQUIARO,1227,B,36,81,1,2,0,0,0,0,0,120,0,0,120,
SANTIAGO PAPASQUIARO,1228,B,86,47,0,1,0,0,0,0,0,134,0,4,138,
SANTIAGO PAPASQUIARO,1229,B,190,76,0,1,0,0,0,0,0,267,0,5,272,
SANTIAGO PAPASQUIARO,1230,B,36,22,0,1,0,0,0,0,0,59,0,6,65,
SANTIAGO PAPASQUIARO,1231,B,94,104,0,1,0,0,0,0,1,200,0,8,208,
SANTIAGO PAPASQUIARO,1232,B,27,53,0,0,0,0,0,0,1,81,0,0,81,
SANTIAGO PAPASQUIARO,1233,B,30,14,0,0,0,0,0,0,0,44,0,0,44,
SANTIAGO PAPASQUIARO,1233,X,31,4,0,0,0,0,0,0,0,35,0,2,37,
SANTIAGO PAPASQUIARO,1234,B,45,17,0,1,0,0,0,0,0,63,0,2,65,
SANTIAGO PAPASQUIARO,1234,X,42,3,1,0,0,0,0,0,0,46,0,2,48,
SANTIAGO PAPASQUIARO,1234,X,65,28,0,0,0,0,0,0,0,93,0,1,94,
SANTIAGO PAPASQUIARO,1235,B,104,76,1,4,0,0,0,0,0,185,0,6,191,
SANTIAGO PAPASQUIARO,1236,B,144,131,1,1,0,0,0,0,2,279,0,1,280,
SANTIAGO PAPASQUIARO,1237,B,95,45,0,1,0,0,0,0,0,141,0,2,143,
SANTIAGO PAPASQUIARO,1238,B,134,77,0,1,1,0,0,0,0,213,0,2,215,
SANTIAGO PAPASQUIARO,1239,B,50,61,5,5,4,0,0,0,0,125,0,7,132,
SANTIAGO PAPASQUIARO,1240,B,127,157,0,3,1,0,0,0,0,288,0,2,290,
SANTIAGO PAPASQUIARO,1241,B,38,64,0,2,0,0,0,0,0,104,0,3,107,
SANTIAGO PAPASQUIARO,1242,B,54,112,0,1,0,0,0,0,1,168,0,3,171,
SANTIAGO PAPASQUIARO,1243,B,62,149,0,1,0,0,0,0,0,212,0,0,212,
SANTIAGO PAPASQUIARO,1244,B,73,134,0,3,2,0,0,0,1,213,0,4,217,
SANTIAGO PAPASQUIARO,1245,B,78,181,1,8,1,0,0,0,0,269,0,6,275,
SANTIAGO PAPASQUIARO,1246,B,46,69,0,1,0,0,0,0,0,116,0,2,118,
SANTIAGO PAPASQUIARO,1247,B,33,52,0,3,0,0,0,0,0,88,0,3,91,
SANTIAGO PAPASQUIARO,1248,B,50,70,0,1,0,0,0,0,0,121,0,2,123,
SANTIAGO PAPASQUIARO,1249,B,172,59,0,1,0,0,0,0,1,233,0,4,237,
SANTIAGO PAPASQUIARO,1250,B,49,122,1,2,0,0,0,0,0,174,0,10,184,
SANTIAGO PAPASQUIARO,1251,B,74,24,0,0,0,0,0,0,0,98,0,0,98,
SANTIAGO PAPASQUIARO,1252,B,16,23,0,0,0,0,0,0,0,39,0,2,41,
SANTIAGO PAPASQUIARO,1253,B,61,17,0,0,0,0,0,0,0,78,0,1,79,
SANTIAGO PAPASQUIARO,1254,B,33,11,1,1,0,0,0,0,0,46,0,0,46,
SANTIAGO PAPASQUIARO,1255,B,21,46,0,1,0,0,0,0,1,69,0,4,73,
SANTIAGO PAPASQUIARO,1256,B,34,83,2,1,0,0,0,0,0,120,0,2,122,
SANTIAGO PAPASQUIARO,1257,B,47,54,0,6,0,0,0,0,0,107,0,1,108,
SANTIAGO PAPASQUIARO,1258,B,71,87,0,1,0,0,0,0,0,159,0,0,159,
SANTIAGO PAPASQUIARO,1259,B,92,73,0,0,0,0,0,0,0,165,0,1,166,
SANTIAGO PAPASQUIARO,1260,B,94,113,1,1,0,0,0,0,0,209,0,3,212,
SANTIAGO PAPASQUIARO,1260,X,86,58,0,2,0,0,0,0,0,146,0,5,151,
SANTIAGO PAPASQUIARO,1261,B,94,97,0,1,0,0,0,0,0,192,0,4,196,
SANTIAGO PAPASQUIARO,1391,B,99,21,0,3,1,0,0,0,0,124,0,1,125,
,,,,,,,,,,,,,,,,
SUCHIL,1263,B,55,183,77,9,0,0,0,0,17,341,0,10,351,
SUCHIL,1264,B,58,191,83,7,0,0,0,0,5,344,0,2,346,
SUCHIL,1265,B,27,92,77,14,0,0,0,0,5,215,0,3,218,
SUCHIL,1265,C,36,76,102,16,0,0,0,0,6,236,0,0,236,
SUCHIL,1266,B,38,90,88,12,0,0,0,0,28,256,0,6,262,
SUCHIL,1266,C,46,88,73,14,0,0,0,0,34,255,0,7,262,
SUCHIL,1267,B,0,23,42,2,0,0,0,0,14,81,1,1,83,
SUCHIL,1268,B,14,47,82,7,0,0,0,0,95,245,0,6,251,
SUCHIL,1269,B,26,44,52,6,0,0,0,0,6,134,0,0,134,
SUCHIL,1270,B,2,4,5,1,0,0,0,0,28,40,0,0,40,
SUCHIL,1271,B,27,42,49,3,0,0,0,0,32,153,0,0,153,
SUCHIL,1272,B,9,17,43,4,0,0,0,0,13,86,0,2,88,
SUCHIL,1273,B,4,62,68,3,0,0,0,0,19,156,0,0,156,
,,,,,,,,,,,,,,,,
TAMAZULA,1274,B,90,150,0,0,0,0,0,0,0,240,0,5,245,
TAMAZULA,1274,C,89,161,0,0,0,0,0,0,0,250,0,8,258,
TAMAZULA,1275,B,242,140,0,0,0,0,0,0,0,382,0,8,390,
TAMAZULA,1276,B,24,34,0,0,0,0,0,0,0,58,0,0,58,
TAMAZULA,1277,B,52,83,0,0,0,0,0,0,0,135,0,10,145,
TAMAZULA,1277,X,15,76,0,0,0,0,0,0,0,91,0,1,92,
TAMAZULA,1278,B,11,50,0,0,0,0,0,0,0,61,0,0,61,
TAMAZULA,1279,B,36,94,0,0,0,0,0,0,0,130,0,6,136,
TAMAZULA,1280,B,24,111,0,0,0,0,0,0,0,135,0,5,140,
TAMAZULA,1281,B,78,287,0,0,0,0,0,0,0,365,0,6,371,
TAMAZULA,1282,B,59,130,0,0,0,0,0,0,0,189,0,1,190,
TAMAZULA,1283,B,15,88,0,0,0,0,0,0,0,103,0,0,103,
TAMAZULA,1284,B,8,37,0,0,0,0,0,0,0,45,0,0,45,
TAMAZULA,1285,B,8,63,0,0,0,0,0,0,0,71,0,3,74,
TAMAZULA,1286,B,102,78,0,0,0,0,0,0,0,180,0,7,187,
TAMAZULA,1287,B,55,45,0,0,0,0,0,0,0,100,0,2,102,
TAMAZULA,1287,X,29,21,0,0,0,0,0,0,0,50,0,0,50,
TAMAZULA,1288,B,43,69,0,0,0,0,0,0,0,112,0,5,117,
TAMAZULA,1289,B,125,31,0,0,0,0,0,0,0,156,0,5,161,
TAMAZULA,1290,B,229,131,0,0,0,0,0,0,0,360,0,20,380,
TAMAZULA,1291,B,55,26,0,0,0,0,0,0,0,81,0,1,82,
TAMAZULA,1292,B,143,93,0,0,0,0,0,0,0,236,0,6,242,
TAMAZULA,1293,B,64,133,0,0,0,0,0,0,0,197,0,8,205,
TAMAZULA,1294,B,47,223,0,0,0,0,0,0,0,270,0,3,273,
TAMAZULA,1295,B,6,62,0,0,0,0,0,0,0,68,0,2,70,
TAMAZULA,1295,X,13,38,0,0,0,0,0,0,0,51,0,1,52,
TAMAZULA,1296,B,28,48,0,0,0,0,0,0,0,76,0,8,84,
TAMAZULA,1297,B,10,142,0,0,0,0,0,0,0,152,,0,152,
TAMAZULA,1298,B,21,227,0,0,0,0,0,0,0,248,,7,255,
TAMAZULA,1299,B,10,158,0,0,0,0,0,0,0,168,0,10,178,
TAMAZULA,1299,X,18,136,0,0,0,0,0,0,0,154,,3,157,
TAMAZULA,1300,B,34,166,0,0,0,0,0,0,0,200,,8,208,
TAMAZULA,1300,C,36,149,0,0,0,0,0,0,0,185,0,9,194,
TAMAZULA,1301,B,51,37,0,0,0,0,0,0,0,88,0,10,98,
TAMAZULA,1302,B,48,9,0,0,0,0,0,0,0,57,0,1,58,
TAMAZULA,1303,B,16,6,0,0,0,0,0,0,0,22,0,0,22,
TAMAZULA,1304,B,5,56,0,0,0,0,0,0,0,61,0,7,68,
TAMAZULA,1305,B,25,6,0,0,0,0,0,0,0,31,,0,31,
,,,,,,,,,,,,,,,,
TEPEHUANES,1306,B,209,201,0,5,0,0,0,0,4,419,0,14,433,
TEPEHUANES,1307,B,81,149,0,3,0,0,0,0,1,234,0,5,239,
TEPEHUANES,1308,B,99,99,0,1,0,0,0,0,0,199,0,1,200,
TEPEHUANES,1309,B,115,93,0,4,0,0,0,0,0,212,0,4,216,
TEPEHUANES,1309,C,122,113,0,2,0,0,0,0,2,239,0,9,248,
TEPEHUANES,1310,B,166,160,0,0,0,0,0,0,0,326,0,11,337,
TEPEHUANES,1311,B,17,102,0,0,0,0,0,0,1,120,0,0,120,
TEPEHUANES,1311,X,37,47,0,1,0,0,0,0,0,85,0,3,88,
TEPEHUANES,1312,B,49,46,0,3,0,0,0,0,1,99,0,7,106,
TEPEHUANES,1312,X,15,75,0,0,0,0,0,0,0,90,0,2,92,
TEPEHUANES,1313,B,33,34,0,0,0,0,0,0,1,68,0,4,72,
TEPEHUANES,1314,B,55,61,0,0,0,0,0,0,1,117,0,1,118,
TEPEHUANES,1315,B,3,54,0,0,0,0,0,0,0,57,0,2,59,
TEPEHUANES,1316,B,22,29,0,0,0,0,0,0,0,51,0,4,55,
TEPEHUANES,1317,B,38,31,0,0,0,0,0,0,0,69,0,1,70,
TEPEHUANES,1318,B,53,35,0,0,0,0,0,0,0,88,0,8,96,
TEPEHUANES,1318,X,42,35,0,5,0,0,0,0,1,83,0,1,84,
TEPEHUANES,1319,B,72,50,0,0,0,0,0,0,0,122,0,6,128,
TEPEHUANES,1320,B,24,31,0,0,0,0,0,0,0,55,0,4,59,
TEPEHUANES,1321,B,92,76,0,1,0,0,0,0,0,169,0,4,173,
TEPEHUANES,1322,B,26,65,0,0,0,0,0,0,0,91,0,3,94,
TEPEHUANES,1323,B,13,81,0,0,0,0,0,0,0,94,0,2,96,
TEPEHUANES,1324,B,101,72,0,2,0,0,0,0,0,175,0,9,184,
TEPEHUANES,1325,B,28,78,0,0,0,0,0,0,1,107,0,8,115,
TEPEHUANES,1326,B,100,106,0,0,0,0,0,0,0,206,0,4,210,
TEPEHUANES,1327,B,30,40,0,0,0,0,0,0,1,71,0,1,72,
TEPEHUANES,1328,B,38,39,0,2,0,0,0,0,0,79,0,4,83,
TEPEHUANES,1329,B,44,83,0,4,0,0,0,0,1,132,0,4,136,
TEPEHUANES,1330,B,50,107,0,1,0,0,0,0,1,159,0,5,164,
TEPEHUANES,1330,X,30,57,0,1,0,0,0,0,0,88,0,0,88,
TEPEHUANES,1331,B,30,45,0,0,0,0,0,0,0,75,0,3,78,
TEPEHUANES,1332,B,21,31,0,0,0,0,0,0,1,53,0,5,58,
,,,,,,,,,,,,,,,,
TLAHUALILO,1333,B,64,66,6,31,7,0,0,0,115,289,0,4,293,
TLAHUALILO,1333,C,53,54,13,42,4,0,0,0,108,274,0,7,281,
TLAHUALILO,1334,B,95,91,15,84,5,0,0,0,122,412,0,10,422,
TLAHUALILO,1335,B,59,73,22,26,4,0,0,0,66,250,0,4,254,
TLAHUALILO,1335,C,71,61,9,27,3,0,0,0,82,253,0,3,256,
TLAHUALILO,1336,B,68,68,20,46,12,0,0,0,124,338,0,3,341,
TLAHUALILO,1337,B,124,71,14,36,8,0,0,0,131,384,0,6,390,
TLAHUALILO,1338,B,107,93,6,31,10,0,0,0,123,370,0,8,378,
TLAHUALILO,1339,B,112,118,16,25,10,0,0,0,120,401,0,5,406,
TLAHUALILO,1340,B,74,74,10,40,15,0,0,0,100,313,0,4,317,
TLAHUALILO,1341,B,72,93,5,35,7,0,0,0,96,308,0,2,310,
TLAHUALILO,1342,B,52,27,3,1,0,0,0,0,16,99,0,4,103,
TLAHUALILO,1343,B,21,10,0,4,0,0,0,0,35,70,0,2,72,
TLAHUALILO,1344,B,35,25,8,35,12,0,0,0,100,215,0,1,216,
TLAHUALILO,1345,B,6,14,1,4,0,0,0,0,46,71,0,3,74,
TLAHUALILO,1346,B,10,74,4,18,6,0,0,0,90,202,0,1,203,
TLAHUALILO,1347,B,56,87,44,32,24,0,0,0,128,371,0,5,376,
TLAHUALILO,1347,X,20,25,0,4,1,0,0,0,28,78,0,2,80,
TLAHUALILO,1348,B,13,21,1,14,0,0,0,0,10,59,0,1,60,
TLAHUALILO,1349,B,63,49,4,19,2,0,0,0,63,200,0,3,203,
TLAHUALILO,1350,B,2,30,1,4,0,0,0,0,55,92,0,0,92,
TLAHUALILO,1351,B,12,4,2,2,0,0,0,0,29,49,0,0,49,
TLAHUALILO,1352,B,57,110,23,20,1,0,0,0,49,260,0,6,266,
TLAHUALILO,1353,B,45,103,10,30,4,0,0,0,98,290,0,7,297,
TLAHUALILO,1353,C,44,95,8,25,1,0,0,0,92,265,0,7,272,
TLAHUALILO,1354,B,26,92,2,1,2,0,0,0,88,211,0,7,218,
TLAHUALILO,1354,C,37,114,4,6,1,0,0,0,76,238,0,3,241,
TLAHUALILO,1355,B,6,52,7,1,1,0,0,0,60,127,0,2,129,
TLAHUALILO,1356,B,70,37,5,12,1,0,0,0,9,134,0,7,141,
TLAHUALILO,1357,B,62,164,62,98,4,0,0,0,93,483,0,7,490,
TLAHUALILO,1358,B,37,73,18,53,5,0,0,0,72,258,0,3,261,
TLAHUALILO,1358,C,43,69,24,60,0,0,0,0,48,244,0,6,250,
TLAHUALILO,1359,B,35,129,1,27,0,0,0,0,30,222,0,5,227,
TLAHUALILO,1359,C,53,70,9,30,0,0,0,0,51,213,0,0,213,
,,,,,,,,,,,,,,,,
TOPIA,1360,B,148,145,0,8,0,0,0,0,25,326,0,16,342,
TOPIA,1361,B,87,98,0,2,0,0,0,0,15,202,0,2,204,
TOPIA,1362,B,89,122,0,1,0,0,0,0,39,251,0,7,258,
TOPIA,1363,B,31,14,0,0,0,0,0,0,1,46,0,0,46,
TOPIA,1364,B,8,51,0,0,0,0,0,0,0,59,0,0,59,
TOPIA,1365,B,36,144,0,1,0,0,0,0,4,185,0,3,188,
TOPIA,1366,B,12,20,0,0,0,0,0,0,1,33,0,1,34,
TOPIA,1367,B,46,14,0,2,0,0,0,0,1,63,0,1,64,1367 B Y 1368 B ANULADAS POR EL TRIBUNAL ESTATAL ELECTORAL
TOPIA,1368,B,12,30,0,1,0,0,0,0,0,43,0,2,45,1367 B Y 1368 B ANULADAS POR EL TRIBUNAL ESTATAL ELECTORAL
TOPIA,1369,B,65,21,0,3,0,0,0,0,91,180,0,7,187,
TOPIA,1369,X,66,31,0,1,0,0,0,0,19,117,0,2,119,
TOPIA,1370,B,41,44,0,2,0,0,0,0,16,103,0,1,104,
TOPIA,1371,B,46,56,0,0,0,0,0,0,2,104,0,7,111,
TOPIA,1372,B,49,147,0,0,0,0,0,0,3,199,0,7,206,
TOPIA,1373,B,217,60,0,1,0,0,0,0,8,286,0,19,305,
,,,,,,,,,,,,,,,,
VICENTE GUERRERO,1374,B,78,61,8,64,12,,,0,0,223,0,8,231,
VICENTE GUERRERO,1374,C,65,72,13,75,5,0,0,0,1,231,0,5,236,
VICENTE GUERRERO,1375,B,95,105,14,88,1,0,0,0,2,305,0,7,312,
VICENTE GUERRERO,1375,C,102,92,13,96,6,0,0,0,3,312,0,9,321,
VICENTE GUERRERO,1376,B,73,60,16,78,4,0,0,0,2,233,0,5,238,
VICENTE GUERRERO,1376,C,63,82,19,66,3,0,0,0,1,234,0,6,240,
VICENTE GUERRERO,1377,B,169,69,8,69,1,0,0,0,2,318,0,7,325,
VICENTE GUERRERO,1377,C,120,86,8,91,4,0,0,0,0,309,0,7,316,
VICENTE GUERRERO,1378,B,229,97,16,84,7,0,0,0,3,436,0,3,439,
VICENTE GUERRERO,1379,B,157,134,13,135,4,0,0,0,0,443,0,6,449,
VICENTE GUERRERO,1380,B,127,85,9,61,9,0,0,0,1,292,0,13,305,
VICENTE GUERRERO,1380,C,111,83,8,55,5,0,0,0,1,263,0,13,276,
VICENTE GUERRERO,1381,B,62,46,12,59,0,0,0,0,4,183,0,0,183,
VICENTE GUERRERO,1381,C,97,41,6,62,2,0,0,0,2,210,0,9,219,
VICENTE GUERRERO,1382,B,139,122,20,97,13,0,0,0,5,396,0,17,413,
VICENTE GUERRERO,1383,B,138,87,20,60,3,0,0,0,2,310,1,10,321,
VICENTE GUERRERO,1383,C,119,96,19,72,4,0,0,0,2,312,0,6,318,
VICENTE GUERRERO,1384,B,128,114,59,97,2,0,0,0,0,400,0,11,411,
VICENTE GUERRERO,1385,B,51,67,12,74,83,0,0,0,3,290,,35,325,
VICENTE GUERRERO,1386,B,71,60,3,63,1,0,0,0,3,201,0,14,215,
VICENTE GUERRERO,1387,B,49,85,16,138,19,0,0,0,2,309,0,5,314,
VICENTE GUERRERO,1387,C,58,84,14,113,11,0,0,0,7,287,0,6,293,
VICENTE GUERRERO,1388,B,20,8,6,32,1,0,0,0,12,79,,11,90,
VICENTE GUERRERO,1389,B,25,29,6,103,5,0,0,0,2,170,,21,191,
VICENTE GUERRERO,1390,B,20,60,10,160,2,0,0,0,1,253,0,8,261,
